浩元热镀圆	钢铁	钢 材、合金钢材	管材及附件
奶精	轻工、医药产品	饮食品	乳制品，蜂蜜、王浆、粉
螺旋	钢铁	钢 材、合金钢材	管材及附件
半圆形金属框架	化工原料及制品	针织、纺织、皮毛及制品	印刷品
热镀圆	钢铁	钢 材、合金钢材	管材及附件
钢丝鱼药	钢铁	钢铁制品	钢铁材料、结构体
钢塑	钢铁	钢 材、合金钢材	带材
热镀管	钢铁	钢 材、合金钢材	管材及附件
螺旋加焊管	钢铁	钢 材、合金钢材	管材及附件
金诚热镀管	钢铁	钢 材、合金钢材	型材
铁合金	钢铁	生铁、铁合金、非合金钢	铁合金
莱钢螺旋	钢铁	钢 材、合金钢材	管材及附件
镀锌管	钢铁	钢 材、合金钢材	管材及附件
铝锭	有色金属	铝	精铝及铝材
纤维板	钢铁	钢铁制品	条、杆、角、网、栅、丝材
乌精粉纽曼	轻工、医药产品	饮食品	其它未列名饮食及调味食品
不锈钢	钢铁	钢 材、合金钢材	带材
轻型胶纸板	轻工、医药产品	纸及制品(十类)	机制纸（新闻纸）
热加钢塑	钢铁	钢 材、合金钢材	管材及附件
精致轻量涂布纸	轻工、医药产品	饮食品	其它未列名饮食及调味食品
螺旋管	钢铁	钢 材、合金钢材	管材及附件
焊管莱钢	钢铁	钢 材、合金钢材	管材及附件
热镀方矩管	钢铁	钢 材、合金钢材	管材及附件
钢棒	钢铁	钢 材、合金钢材	型材
焊管发莱钢	钢铁	钢 材、合金钢材	管材及附件
油槽数控铣床	机械设备、电器	普通工业机械及设备	金属加工机械及设备
铁精粉	金属矿石	铁矿石	其它
焊管	钢铁	钢 材、合金钢材	管材及附件
扁铁丝	钢铁	生铁、铁合金、非合金钢	铁或非合金钢板轧材、卷、角、型材
钢丝排	钢铁	钢铁制品	钢铁材料、结构体
钢格板	钢铁	钢 材、合金钢材	钢铁材料、结构体
PCl铝模板	有色金属	铝	精铝及铝材
热镀圆钢塑	钢铁	钢 材、合金钢材	线材
印刷原纸	轻工、医药产品	纸及制品(十类)	机制纸（新闻纸）
热轧态钢板	钢铁	钢 材、合金钢材	板材
热方	钢铁	钢 材、合金钢材	管材及附件
工字钢	钢铁	钢 材、合金钢材	型材
焊管加螺旋	钢铁	钢铁制品	钢铁件及其它五金制品
热镀管箱	钢铁	钢 材、合金钢材	管材及附件
镀锌扁铁	钢铁	钢 材、合金钢材	管材及附件
圆钢	钢铁	钢 材、合金钢材	线材
热镀	钢铁	钢 材、合金钢材	管材及附件
啤酒	轻工、医药产品	饮食品	酒（白酒、啤酒、果酒类）
纸箱	轻工、医药产品	纸及制品(十类)	纺织材料包、套等，复合材料纱、线、绳
焦煤	煤炭及制品	原煤	无烟煤
烟煤	煤炭及制品	原煤	烟煤
食品包装纸	轻工、医药产品	饮食品	罐头，硬、软包装食品
玉淀粉	金属矿石	铁矿石	其它
白胶板印刷纸	轻工、医药产品	纸及制品(十类)	机制纸（新闻纸）
陶瓷透水砖	轻工、医药产品	日用工业品	陶瓷制品
热镀圆工具	钢铁	钢 材、合金钢材	线材
纱	轻工、医药产品	针织、纺织、皮毛及制品	纱、线、丝、纤维（非复合材料）
银杏	农、林、牧、渔业产品	竹、木、藤、花、草	树木
镀锌扁钢	钢铁	钢 材、合金钢材	型材
箱	其它货类	其它	其它
象牙白数码纸	轻工、医药产品	纸及制品(十类)	机制纸（新闻纸）
热处理钢板	钢铁	钢 材、合金钢材	板材
铁质料架	其它货类	工艺美术品	普通金属工艺品
热轧钢板	钢铁	钢 材、合金钢材	板材
矿砂	金属矿石	铁矿石	其它
扁铁	钢铁	生铁、铁合金、非合金钢	板材
福通南非精粉	金属矿石	铁矿石	其它
迪特拉印度粉	轻工、医药产品	饮食品	酒（白酒、啤酒、果酒类）
冷卷镀锌卷	钢铁	钢 材、合金钢材	管材及附件
热镀锌方管	钢铁	钢 材、合金钢材	管材及附件
铁质货架	钢铁	钢铁制品	钢铁件及其它五金制品
红叶石楠	农、林、牧、渔业产品	竹、木、藤、花、草	树木
黑粉	钢铁	钢 材、合金钢材	其它
热镀圆加螺旋	钢铁	钢 材、合金钢材	线材
糊精口服糖	轻工、医药产品	纸及制品(十类)	机制纸（新闻纸）
尺集装箱柜	轻工、医药产品	文化体育用品	文教办公用品
袋	轻工、医药产品	日用化工品	管材及附件
热镀圆加钢塑	钢铁	钢 材、合金钢材	线材
焊管加热镀圆	钢铁	钢 材、合金钢材	管材及附件
一水糖糊精	轻工、医药产品	饮食品	糖（固体、浆）
热镀圆FA	钢铁	钢 材、合金钢材	管材及附件
和光巴西粗粉	机械设备、电器	交通运输设备	道路机动车辆
焊管 螺旋	钢铁	钢 材、合金钢材	管材及附件
印度粗粉	金属矿石	铁矿石	其它
如皋港热镀	有色金属	钢 材、合金钢材	板材
PI粉	金属矿石	铁矿石	其它
巴西粗粉	金属矿石	铁矿石	其它
化肥	钢铁	钢 材、合金钢材	管材及附件
焊管加黑方	钢铁	钢 材、合金钢材	管材及附件
铜铁胶	钢铁	焦炭	其它
火箭粉	轻工、医药产品	文化体育用品	布匹（机织、绒织、网织物、纱罗）
巴西粉混合	金属矿石	铁矿石	其它
烟煤绿地	煤炭及制品	原煤	烟煤
热镀 钢塑	钢铁	钢 材、合金钢材	管材及附件
电线杆	钢铁	钢铁制品	钢铁容器
船板	钢铁	钢 材、合金钢材	板材
剪铁	钢铁	生铁、铁合金、非合金钢	铁合金
锰粉	金属矿石	锰矿石	其它
普拉蒂印度粉	轻工、医药产品	工艺美术品	普通金属工艺品
镍铁	钢铁	生铁、铁合金、非合金钢	铁合金
印度粉	金属矿石	铁矿石	其它
葛金正源葛方管	钢铁	钢铁制品	钢铁件及其它五金制品
镀锌冷轧	钢铁	钢 材、合金钢材	管材及附件
钢管黑方加焊管	钢铁	钢 材、合金钢材	管材及附件
南非精粉	金属矿石	铁矿石	其它
车钢塑	钢铁	钢 材、合金钢材	卷材
热镀钢塑	钢铁	钢 材、合金钢材	管材及附件
柴油机配件	机械设备、电器	普通工业机械及设备	重工业机械、工程机械及零件
军用钢	钢铁	钢 材、合金钢材	带材
lu螺旋	钢铁	钢 材、合金钢材	管材及附件
热镀加热方和螺旋	钢铁	钢 材、合金钢材	管材及附件
迪拜宝石印度粉	轻工、医药产品	工艺美术品	其它
螺旋焊管	钢铁	钢 材、合金钢材	管材及附件
铁塔	钢铁	生铁、铁合金、非合金钢	铁合金
钢塑加热镀	钢铁	钢 材、合金钢材	管材及附件
澳州西部粉	金属矿石	钢 材、合金钢材	管材及附件
车钢塑加热镀圆	钢铁	钢 材、合金钢材	铁或非合金钢板轧材、卷、角、型材
热镀加热方	钢铁	钢 材、合金钢材	管材及附件
热镀锌合金锭	钢铁	钢 材、合金钢材	管材及附件
原浆板	钢铁	钢 材、合金钢材	管材及附件
镀锌圆	钢铁	钢 材、合金钢材	管材及附件
铁塔配件	煤炭及制品	原煤	烟煤
低合金开平板	钢铁	钢 材、合金钢材	板材
铁质料架与挡杆	其它货类	工艺美术品	普通金属工艺品
精粉	金属矿石	铁矿石	其它
叉车	机械设备、电器	交通运输设备	道路机动车辆
盘螺	钢铁	钢 材、合金钢材	线材
印粉	轻工、医药产品	工艺美术品	雕塑、刻、漆工艺品
板栗树	农、林、牧、渔业产品	竹、木、藤、花、草	树木
螺旋套管	钢铁	钢 材、合金钢材	管材及附件
天空粉	金属矿石	锰矿石	其它
伊莱亚斯印度粗粉	轻工、医药产品	工艺美术品	纸浆
铬合金螺纹钢	钢铁	钢 材、合金钢材	线材
螺旋加焊管的螺旋	钢铁	钢 材、合金钢材	管材及附件
丝束	轻工、医药产品	针织、纺织、皮毛及制品	布匹（机织、绒织、网织物、纱罗）
澳粉矿	金属矿石	铁矿石	其它
水渣	农、林、牧、渔业产品	其它	其它
H钢	钢铁	钢 材、合金钢材	型材
金属螺旋	钢铁	钢 材、合金钢材	管材及附件
螺旋管套管	钢铁	钢 材、合金钢材	管材及附件
艾利印度粉	轻工、医药产品	日用工业品	家具、坐具
铁制料架	钢铁	钢铁制品	其它
电线电缆	机械设备、电器	电力设备、电器机械及器材	家用电器
基纳巴卢巴粗粉	轻工、医药产品	专用机械、设备及制品	其它专用机械、设备
料架	钢铁	钢铁制品	钢铁件及其它五金制品
西部澳粉矿	金属矿石	铁矿石	其它
合金	钢铁	钢铁制品	美容化妆品
热镀 焊管 螺旋	钢铁	钢 材、合金钢材	管材及附件
印度巴粉	金属矿石	铁矿石	其它
电缆设备	机械设备、电器	电力设备、电器机械及器材	家用电器
车热镀圆	钢铁	钢 材、合金钢材	管材及附件
矿精粉	金属矿石	铁矿石	其它
设备	钢铁	钢 材、合金钢材	线材
铁架	钢铁	钢 材、合金钢材	钢铁件及其它五金制品
炉渣	轻工、医药产品	针织、纺织、皮毛及制品	其它
超细粉	金属矿石	铁矿石	其它
发重庆螺旋	钢铁	钢 材、合金钢材	型材
液压马达	化工原料及制品	日用化工品	其它
帕拉伯度粉	化工原料及制品	其它未列名化工原料及制品	普通金属工艺品
宙斯南非精粉	轻工、医药产品	工艺美术品	普通金属工艺品
发柳州车热镀管	钢铁	钢 材、合金钢材	管材及附件
弱焦煤	煤炭及制品	原煤	烟煤
金鱼闪击干燥浆	化工原料及制品	经济作物及制品	其它
安特拉斯粉	钢铁	钢 材、合金钢材	钢铁容器
燃气镀锌管	钢铁	钢 材、合金钢材	管材及附件
螺旋和钢塑	钢铁	钢 材、合金钢材	管材及附件
铝块	有色金属	铝	精铝及铝材
热镀圆加白方	钢铁	钢 材、合金钢材	线材
铁板	钢铁	钢 材、合金钢材	板材
铬铁	钢铁	钢 材、合金钢材	卷材
中云勐滨白糖	化工原料及制品	钢铁制品	通用设备
淀粉YS	轻工、医药产品	饮食品	糕点、面食、谷物食品
铁矿砂	金属矿石	铁矿石	其它
热镀圆焊管白方	钢铁	钢 材、合金钢材	管材及附件
螺旋 焊管	钢铁	钢 材、合金钢材	管材及附件
花纹铝板	钢铁	钢 材、合金钢材	板材
热镀加钢塑加螺旋	钢铁	钢 材、合金钢材	管材及附件
沙热镀箱	钢铁	钢 材、合金钢材	管材及附件
南非粉	金属矿石	铁矿石	其它
津巴布韦粉	金属矿石	铁矿石	其它
南粉	金属矿石	铁矿石	其它
镀圆加热镀方	钢铁	钢 材、合金钢材	管材及附件
南粉.％	金属矿石	铁矿石	其它
铁矿砂t	金属矿石	铁矿石	其它
热轧板坯汽运	钢铁	钢 材、合金钢材	板材
泡棉	轻工、医药产品	针织、纺织、皮毛及制品	布匹（机织、绒织、网织物、纱罗）
螺旋发吴江	钢铁	钢 材、合金钢材	管材及附件
螺旋发西安	钢铁	钢 材、合金钢材	管材及附件
南粉/	金属矿石	铁矿石	其它
螺旋发茌平	钢铁	钢 材、合金钢材	管材及附件
玉种子	轻工、医药产品	经济作物及制品	其它
F粉	金属矿石	铁矿石	其它
南非粉球团	金属矿石	铁矿石	其它
车焊钢塑	钢铁	钢 材、合金钢材	管材及附件
镀锌线管	钢铁	钢 材、合金钢材	管材及附件
钢塑热镀	钢铁	钢 材、合金钢材	管材及附件
罗泊河粉	其它货类	钢 材、合金钢材	其它
螺旋发沁阳	钢铁	钢 材、合金钢材	管材及附件
焊管螺旋发荆州	钢铁	钢 材、合金钢材	管材及附件
铝绞线	有色金属	铝	铝制品
津巴布韦粉.	金属矿石	铁矿石	其它
津巴布韦粉.％	金属矿石	铁矿石	其它
焊螺发铜冶	钢铁	钢 材、合金钢材	线材
津巴布韦粉％	金属矿石	铁矿石	其它
鱼粉	金属矿石	镍矿石	其它
焊钢塑	钢铁	钢 材、合金钢材	型材
防腐油膏	化工原料及制品	日用化工品	钢铁件及其它五金制品
钢线材	钢铁	钢 材、合金钢材	型材
螺旋发铜冶	钢铁	钢 材、合金钢材	管材及附件
螺旋发宁波	钢铁	钢 材、合金钢材	管材及附件
物料和铜线	其它货类	橡胶	其它
南粉。	金属矿石	铁矿石	其它
母线槽	钢铁	钢 材、合金钢材	型材
螺旋方矩管热镀管	钢铁	钢 材、合金钢材	管材及附件
南粉，	金属矿石	铁矿石	其它
螺旋发安阳	钢铁	钢 材、合金钢材	管材及附件
FNG西部粉	金属矿石	铁矿石	其它
罗伊山粉	金属矿石	铁矿石	其它
钢筋桁架镀锌板	钢铁	钢铁制品	线材
轮胎	化工原料及制品	橡胶	橡胶制品
粉矿	金属矿石	铁矿石	其它
钢管黑方	钢铁	钢 材、合金钢材	管材及附件
圆管发银川	钢铁	钢 材、合金钢材	管材及附件
铁材	钢铁	钢 材、合金钢材	铁合金
速线材	钢铁	钢 材、合金钢材	卷材
硅铁	钢铁	生铁、铁合金、非合金钢	铁合金
钢管热方	钢铁	钢 材、合金钢材	管材及附件
南粉.,	金属矿石	铁矿石	其它
马块.％	轻工、医药产品	饮食品	其它
南粉,	金属矿石	铁矿石	其它
铜线十物料	机械设备、电器	钢 材、合金钢材	线材
啤	轻工、医药产品	饮食品	酒（白酒、啤酒、果酒类）
淀粉糖	轻工、医药产品	饮食品	糖（固体、浆）
号原煤	煤炭及制品	生铁、铁合金、非合金钢	铁或非合金钢板轧材、卷、角、型材
不锈钢钢坯	钢铁	钢 材、合金钢材	带材
方管加螺旋	钢铁	钢 材、合金钢材	管材及附件
货场铁矿粉	金属矿石	铁矿石	其它
锌渣热镀方矩管区	钢铁	钢 材、合金钢材	管材及附件
仪表板总成	机械设备、电器	仪器仪表、计量器具、工具	仪器仪表
铬	钢铁	钢 材、合金钢材	管材及附件
巴西粉矿	金属矿石	铁矿石	其它
母线	钢铁	钢铁制品	美容化妆品
邯郸钢易螺旋热镀钢塑	钢铁	钢铁制品	条、杆、角、网、栅、丝材
钬粉	金属矿石	镍矿石	其它
巴西南部粉	金属矿石	铁矿石	其它
硅巴粗粉	金属矿石	铁矿石	其它
铜精粉	轻工、医药产品	铁矿石	其它
不锈钢管	钢铁	钢 材、合金钢材	管材及附件
淀粉乳	轻工、医药产品	饮食品	乳制品，蜂蜜、王浆、粉
敬业铁矿粉	钢铁	铁矿石	其它
防腐螺旋钢管	钢铁	钢 材、合金钢材	管材及附件
抗震钢盘螺	钢铁	钢 材、合金钢材	线材
铝包钢芯铝绞线	有色金属	铝	铝制品
螺旋发周口	钢铁	钢 材、合金钢材	管材及附件
热镀方矩管螺旋管热镀管方矩管	钢铁	钢 材、合金钢材	管材及附件
天津码头铁矿粉	轻工、医药产品	工艺美术品	雕塑、刻、漆工艺品
钢芯铝绞线	钢铁	钢 材、合金钢材	板材
津布巴粉矿	轻工、医药产品	饮食品	雕塑、刻、漆工艺品
导电方钢	钢铁	钢 材、合金钢材	管材及附件
焊管螺旋管方矩管	钢铁	钢 材、合金钢材	管材及附件
镀锌角	钢铁	钢 材、合金钢材	管材及附件
漆抛线	机械设备、电器	电力设备、电器机械及器材	美容化妆品
钢绞线	钢铁	钢铁制品	型材
钱粉	金属矿石	镍矿石	其它
甜片油	农、林、牧、渔业产品	经济作物及制品	动植物食用油料、脂肪及制品
铗粉	金属矿石	镍矿石	其它
钢管焊管套管加螺旋	钢铁	钢 材、合金钢材	管材及附件
铁精矿	金属矿石	铁矿石	其它
精品圆钢天津	钢铁	钢 材、合金钢材	线材
精品圆钢湖北	钢铁	钢 材、合金钢材	线材
卷板	钢铁	钢 材、合金钢材	卷材
个板	钢铁	钢 材、合金钢材	家用电器
r热镀	钢铁	钢 材、合金钢材	管材及附件
焊管螺旋管热镀管	钢铁	钢 材、合金钢材	管材及附件
热镀螺旋方矩管	钢铁	钢 材、合金钢材	管材及附件
焊管黑方螺旋	钢铁	钢 材、合金钢材	管材及附件
南粉.%	金属矿石	铁矿石	其它
工业线材	钢铁	钢 材、合金钢材	管材及附件
镀锡板	钢铁	钢 材、合金钢材	板材
钢筋方管	钢铁	钢 材、合金钢材	线材
螺旋管+焊管	钢铁	钢 材、合金钢材	管材及附件
镀锌圆管	钢铁	钢 材、合金钢材	管材及附件
矿粉	金属矿石	铁矿石	其它
热轧圆钢	钢铁	钢 材、合金钢材	线材
马达	轻工、医药产品	纸及制品(十类)	布匹（机织、绒织、网织物、纱罗）
焊管热镀管钢塑冷水管	钢铁	钢 材、合金钢材	管材及附件
钢板	钢铁	钢 材、合金钢材	板材
中压电缆	机械设备、电器	电力设备、电器机械及器材	家用电器
克克精品牛皮纸	轻工、医药产品	纸及制品(十类)	纸制品
特粉	金属矿石	铁矿石	其它
同铁矿粉	金属矿石	铁矿石	其它
阿巴粉	金属矿石	铁矿石	其它
热方螺旋	钢铁	钢 材、合金钢材	管材及附件
矿石粉	金属矿石	铁矿石	其它
巴精粉	金属矿石	铁矿石	其它
螺旋发蚌埠	钢铁	钢 材、合金钢材	管材及附件
电煤	煤炭及制品	原煤	烟煤
天津敬业南港铁矿粉	金属矿石	铁矿石	其它
石油胶	石油、天然气及制品	石油焦	其它
漆包线	轻工、医药产品	针织、纺织、皮毛及制品	体育运动用品及零件、附件
进口铁矿粉	金属矿石	铁矿石	其它
乳清粉	轻工、医药产品	饮食品	动植物食用油料、脂肪及制品
精制轻量淫涂布纸	轻工、医药产品	纸及制品(十类)	机制纸（新闻纸）
钢板螺旋	钢铁	钢 材、合金钢材	管材及附件
其他烟煤	煤炭及制品	原煤	烟煤
津巴粉.%	金属矿石	铁矿石	其它
镍铁加石灰	钢铁	焦炭	其它
阿巴粉.％	金属矿石	铁矿石	其它
镀锌接线盒	钢铁	钢 材、合金钢材	管材及附件
灰板纸	轻工、医药产品	纸及制品(十类)	纸制品
钢塑管冀	钢铁	钢 材、合金钢材	管材及附件
汽车线	机械设备、电器	普通工业机械及设备	通用设备
阿巴粉.%	金属矿石	铁矿石	其它
灰板双胶纸	轻工、医药产品	纸及制品(十类)	电子、光、磁、超声波装置的元器件、零件、附件
巴块.%	金属矿石	铁矿石	其它
电源线	钢铁	钢铁制品	管材及附件
巴块.％	金属矿石	铁矿石	其它
钢塑冷水管螺旋管	钢铁	钢 材、合金钢材	线材
南粉,%	金属矿石	铁矿石	其它
热轧热处理热处理钢板约其余均是热轧汽运	钢铁	钢 材、合金钢材	管材及附件
热轧圆钢汽运费用包括转运费仓储费用不含用户代储费	钢铁	钢 材、合金钢材	线材
模具电线铁笼	机械设备、电器	电子、电讯设备及器材	家用电器
阿曼粉	金属矿石	铁矿石	其它
巴卡粉	金属矿石	铁矿石	其它
董家口流畅邢钢超特粉	轻工、医药产品	纸及制品(十类)	针织、纺织制品
热+钢塑	钢铁	钢 材、合金钢材	条、杆、角、网、栅、丝材
树	农、林、牧、渔业产品	竹、木、藤、花、草	树木
橡胶SR	化工原料及制品	橡胶	合成橡胶
母线桥	钢铁	钢铁制品	铸、锻钢材
杨木浆	轻工、医药产品	纸及制品(十类)	纸浆
超细微粉	轻工、医药产品	饮食品	其它未列名饮食及调味食品
热轧圆钢热轧圆钢汽运	钢铁	钢 材、合金钢材	线材
漆泡线	机械设备、电器	电力设备、电器机械及器材	美容化妆品
万里通超特粉	机械设备、电器	交通运输设备	雕塑、刻、漆工艺品
永洋巴精粉	轻工、医药产品	化工品	雕塑、刻、漆工艺品
纽曼粉矿	其它货类	铁矿石	其它
漆跑线	机械设备、电器	电力设备、电器机械及器材	美容化妆品
伊朗粉	金属矿石	铁矿石	其它
热镀+钢塑	钢铁	钢 材、合金钢材	管材及附件
电线空调配件	机械设备、电器	电力设备、电器机械及器材	家用电器
铁架工具箱	钢铁	钢 材、合金钢材	管材及附件
油桶	轻工、医药产品	日用工业品	钢铁容器
电线钢板	钢铁	钢 材、合金钢材	卷材
石英粉	金属矿石	锰矿石	其它
柴油机	机械设备、电器	普通工业机械及设备	锅炉、发动机 动力装置及辅助设备
热轧船运	钢铁	钢 材、合金钢材	管材及附件
螺旋加焊管加白方	钢铁	钢 材、合金钢材	管材及附件
焊管+螺旋管	钢铁	钢 材、合金钢材	管材及附件
日丰电线	机械设备、电器	普通工业机械及设备	家用电器
钢架	钢铁	钢铁制品	线材
阿拉姆南非中铁	轻工、医药产品	工艺美术品	树木
漆包线三车一起	机械设备、电器	钢铁制品	仪器仪表
铜线电子产品	机械设备、电器	普通工业机械及设备	制冷、加热、燃烧设备
P粉矿	金属矿石	铁矿石	其它
盘螺钢银	钢铁	钢 材、合金钢材	线材
董家口永洋粉	轻工、医药产品	日用工业品	针织、纺织制品
进口矿粉	金属矿石	铁矿石	其它
漆包线金品励	有色金属	铜	体育运动用品及零件、附件
漆包线空调配件	机械设备、电器	电力设备、电器机械及器材	家用电器
粕	农、林、牧、渔业产品	经济作物及制品	经济作物原料、残渣及副产品
电线调拨	机械设备、电器	电力设备、电器机械及器材	电子、光、磁、超声波装置的元器件、零件、附件
模板	钢铁	钢 材、合金钢材	板材
淀粉袋	轻工、医药产品	日用工业品	其它日用品
圆钢汽运包车一定要看清楚要求	钢铁	钢 材、合金钢材	线材
镀锡卷	钢铁	钢 材、合金钢材	其它
螺旋热方	钢铁	钢 材、合金钢材	管材及附件
镀锡卷板	钢铁	钢 材、合金钢材	铁或非合金钢板轧材、卷、角、型材
果树	农、林、牧、渔业产品	竹、木、藤、花、草	饮料、果菜汁
铜线和设备	钢铁	钢 材、合金钢材	线材
添加剂	农、林、牧、渔业产品	其它未列名化工原料及制品	其它
油煤	煤炭及制品	原煤	输变电设备
巴西卡粉	金属矿石	铁矿石	其它
角铁	钢铁	钢 材、合金钢材	板材
斯蒂芬麦粉矿	金属矿石	铁矿石	其它
宝梅卡粉	金属矿石	钢 材、合金钢材	其它
稻壳粉	轻工、医药产品	饮食品	铜箔、丝、粉
热镀圆两磅金山	钢铁	钢 材、合金钢材	管材及附件
热镀发神农架	钢铁	钢 材、合金钢材	管材及附件
发沙螺旋管	钢铁	钢 材、合金钢材	管材及附件
德龙超特粉	金属矿石	铁矿石	其它
盘螺，线材	钢铁	钢 材、合金钢材	线材
董家口超特粉	轻工、医药产品	饮食品	其它未列名饮食及调味食品
铜线	有色金属	铜	铜型、线材、异型材及附件
巴卡粉矿	金属矿石	铁矿石	其它
合板	钢铁	钢 材、合金钢材	板材
挂板牛腿钢垫箱	农、林、牧、渔业产品	钢 材、合金钢材	板材
萨尔瓦多乌精粉品	机械设备、电器	普通工业机械及设备	电子、光、磁、超声波装置的元器件、零件、附件
斯蒂芬麦粉	金属矿石	铁矿石	其它
翡翠麦粉	轻工、医药产品	饮食品	其它未列名饮食及调味食品
王牌麦粉	轻工、医药产品	饮食品	其它未列名饮食及调味食品
黄骅港矿粉	金属矿石	铁矿石	其它
胶粉	轻工、医药产品	饮食品	乳制品，蜂蜜、王浆、粉
敬业黄骅港标载中信澳洲精粉	钢铁	钢 材、合金钢材	板材
董家口万里通超特粉	轻工、医药产品	日用工业品	针织、纺织制品
日出~巴西粉	轻工、医药产品	饮食品	其它未列名饮食及调味食品
中梅巴卡粉矿	钢铁	钢铁制品	管材及附件
镀锡	钢铁	钢铁制品	钢铁件及其它五金制品
南非粉.	金属矿石	铁矿石	其它
电子产品	其它货类	其它	其它
电线电机	机械设备、电器	电力设备、电器机械及器材	家用电器
热镀管焊管钢塑冷水管	钢铁	钢 材、合金钢材	管材及附件
日出巴西粉	轻工、医药产品	饮食品	其它未列名饮食及调味食品
日出/巴西粉	轻工、医药产品	饮食品	其它未列名饮食及调味食品
接触线	机械设备、电器	电力设备、电器机械及器材	美容化妆品
董家口永洋巴粗粉	轻工、医药产品	日用工业品	针织、纺织制品
漆包线热水器	轻工、医药产品	文化体育用品	普通金属工艺品
商河车热镀钢塑	机械设备、电器	钢 材、合金钢材	非合金钢
发西安螺旋	钢铁	钢 材、合金钢材	管材及附件
董家口流畅德龙超特粉	轻工、医药产品	纸及制品(十类)	针织、纺织制品
稀土钢绞线	钢铁	钢铁制品	条、杆、角、网、栅、丝材
铜线和空轴	钢铁	钢铁制品	线材
前湾港巴西砂	农、林、牧、渔业产品	竹、木、藤、花、草	道路机动车辆
漆包线模具	轻工、医药产品	文化体育用品	体育运动用品及零件、附件
PVC树脂粉	金属矿石	铁矿石	其它
萨瓦多乌精粉品	轻工、医药产品	工艺美术品	纸浆
萨尔瓦多乌精粉	机械设备、电器	普通工业机械及设备	电子、光、磁、超声波装置的元器件、零件、附件
贝尔澳大利亚精粉	金属矿石	铁矿石	其它
面包铁	钢铁	生铁、铁合金、非合金钢	生铁
板油	钢铁	钢 材、合金钢材	其它
港生麦粉	轻工、医药产品	饮食品	其它未列名饮食及调味食品
巴西筛后粉	金属矿石	铁矿石	其它
马里尼卡粉	轻工、医药产品	针织、纺织、皮毛及制品	纱、线、丝、纤维（非复合材料）
前湾港巴粗粉	农、林、牧、渔业产品	竹、木、藤、花、草	道路机动车辆
喜悦巴西精粉	轻工、医药产品	饮食品	其它未列名饮食及调味食品
红板	钢铁	钢 材、合金钢材	板材
主焦煤口岸	煤炭及制品	原煤	烟煤
食品ANWL	轻工、医药产品	饮食品	其它未列名饮食及调味食品
麦粉	金属矿石	铁矿石	其它
菲尔卡粉	有色金属	钢 材、合金钢材	其它
线缆	机械设备、电器	其它	金属加工机械及设备
铝包钢	有色金属	铝	铝制品
食品LY	轻工、医药产品	饮食品	其它未列名饮食及调味食品
艾尔卡粉	有色金属	钢 材、合金钢材	其它
安达玛麦粉	钢铁	钢铁制品	其它
设备LH	钢铁	钢 材、合金钢材	线材
皮尔巴拉粉矿	机械设备、电器	专用机械、设备及制品	其它专用机械、设备
国梅卡粉	轻工、医药产品	饮食品	罐头，硬、软包装食品
调拨漆包线	轻工、医药产品	日用工业品	家具、坐具
吨箱	钢铁	钢 材、合金钢材	卷材
电线	机械设备、电器	电力设备、电器机械及器材	电工器材
前湾港超特粉	农、林、牧、渔业产品	竹、木、藤、花、草	铜箔、丝、粉
董家口万里通德龙超特粉	轻工、医药产品	日用工业品	针织、纺织制品
敬业黄骅大载精粉	钢铁	钢 材、合金钢材	板材
淀粉	轻工、医药产品	饮食品	糕点、面食、谷物食品
黄岛麦粉	金属矿石	铁矿石	其它
棉LH	轻工、医药产品	纸及制品(十类)	布匹（机织、绒织、网织物、纱罗）
澳洲丸卡粉	轻工、医药产品	工艺美术品	雕塑、刻、漆工艺品
天津港德龙超特粉	金属矿石	锰矿石	其它
前湾港流畅德龙巴西砂	农、林、牧、渔业产品	竹、木、藤、花、草	其它
前湾港万里通德龙巴西砂	农、林、牧、渔业产品	工艺美术品	雕塑、刻、漆工艺品
巴西粉.	金属矿石	铁矿石	其它
设备LY	钢铁	钢 材、合金钢材	线材
模板LY	钢铁	钢 材、合金钢材	板材
朱塔卡粉	金属矿石	铁矿石	其它
镀铬盒板	钢铁	钢 材、合金钢材	板材
南淀粉	轻工、医药产品	饮食品	动植物食用油料、脂肪及制品
模板YG	钢铁	钢 材、合金钢材	板材
食品	轻工、医药产品	饮食品	其它未列名饮食及调味食品
盘条	钢铁	钢 材、合金钢材	线材
铁矿砂卡洛尔	金属矿石	铁矿石	其它
天津德龙粉	钢铁	钢 材、合金钢材	管材及附件
配件	钢铁	钢 材、合金钢材	铁或非合金钢板轧材、卷、角、型材
带，	钢铁	钢铁制品	钢铁件及其它五金制品
前湾港永洋新巴粗粉	农、林、牧、渔业产品	工艺美术品	雕塑、刻、漆工艺品
董家口流畅超特粉	轻工、医药产品	纸及制品(十类)	针织、纺织制品
澳森黄骅港裕光卡粉	金属矿石	铁矿石	其它
马口铁镀铬卷	钢铁	钢 材、合金钢材	管材及附件
空线轴	机械设备、电器	电力设备、电器机械及器材	家用电器
hp线	钢铁	钢 材、合金钢材	钢铁容器
煤粉	煤炭及制品	原煤	生铁
面板	轻工、医药产品	钢 材、合金钢材	板材
吨包PHJ	钢铁	钢 材、合金钢材	钢铁件及其它五金制品
马口铁镀锡盒板镀锡卷	钢铁	钢 材、合金钢材	管材及附件
南非粉.％	金属矿石	铁矿石	其它
盘螺发港	钢铁	钢 材、合金钢材	线材
前湾港流畅德龙卡罗巴西砂	农、林、牧、渔业产品	竹、木、藤、花、草	其它
角铁GYG	钢铁	钢 材、合金钢材	板材
马口铁镀锡卷	钢铁	钢 材、合金钢材	管材及附件
麦格尼飞化纤	轻工、医药产品	其它未列名化工原料及制品	其它
曹妃甸邢台德龙粉	轻工、医药产品	工艺美术品	纸浆
面粉LYC	轻工、医药产品	饮食品	糕点、面食、谷物食品
前湾港万里通德龙匹粉	农、林、牧、渔业产品	工艺美术品	雕塑、刻、漆工艺品
前湾港流畅德龙匹粉	农、林、牧、渔业产品	竹、木、藤、花、草	其它
粉天津矿产	金属矿石	铁矿石	其它
三友化纤	钢铁	钢铁制品	其它
面粉	轻工、医药产品	饮食品	糕点、面食、谷物食品
线材圆盘	钢铁	钢 材、合金钢材	线材
电煤气	机械设备、电器	原煤	输变电设备
新衢州巴西粉	钢铁	钢 材、合金钢材	管材及附件
新衢州 巴西粉	钢铁	钢 材、合金钢材	管材及附件
煤纳源包铝	钢铁	钢铁制品	其它运输辅件及器材
槽钢	钢铁	钢 材、合金钢材	型材
天津粉	金属矿石	铁矿石	其它
江河金	钢铁	钢 材、合金钢材	型材
棉纱	轻工、医药产品	针织、纺织、皮毛及制品	布匹（机织、绒织、网织物、纱罗）
啤酒桶	轻工、医药产品	日用工业品	其它日用品
硅油	化工原料及制品	其它未列名化工原料及制品	其它
铝	有色金属	铝	精铝及铝材
包装	农、林、牧、渔业产品	蔬菜、瓜果及籽实籽仁	其它
水泥板	钢铁	钢 材、合金钢材	铁或非合金钢板轧材、卷、角、型材
汇线桥架	钢铁	钢 材、合金钢材	线材
面粉箱装头道粉	轻工、医药产品	饮食品	糕点、面食、谷物食品
塞拉利昂粉矿	钢铁	钢 材、合金钢材	其它钢材
散粉	金属矿石	镍矿石	其它
纽曼粉	金属矿石	铁矿石	其它
海角乌精粉低硫	钢铁	钢 材、合金钢材	管材及附件
角高硫乌精粉	钢铁	钢 材、合金钢材	管材及附件
角乌兰精粉	钢铁	钢 材、合金钢材	管材及附件
乌兰精粉	轻工、医药产品	铁矿石	其它
岚桥矿粉	金属矿石	铁矿石	其它
合金锭圆柱锭	化工原料及制品	针织、纺织、皮毛及制品	印刷品
铁矿砂库	金属矿石	铁矿石	其它
德盛海马来矿	金属矿石	铁矿石	其它
日照龙安德龙巴粗粉	机械设备、电器	钢铁制品	电工器材
天津锦亿粉	其它货类	工艺美术品	其它
中文汇通粉	钢铁	钢 材、合金钢材	管材及附件
钢支撑牛腿挂板	化工原料及制品	针织、纺织、皮毛及制品	合成树脂、聚合物
格拉索粉	农、林、牧、渔业产品	文化体育用品	动植物食用油料、脂肪及制品
前湾港万里通粉	农、林、牧、渔业产品	工艺美术品	雕塑、刻、漆工艺品
前湾港德龙流畅粉	农、林、牧、渔业产品	竹、木、藤、花、草	竹
南非粗粉	金属矿石	铁矿石	其它
比速西部粉	钢铁	铁矿石	其它
江河金鱼浆	钢铁	钢 材、合金钢材	型材
瑞钢联金步巴粉	钢铁	钢铁制品	线材
砂	轻工、医药产品	饮食品	动植物食用油料、脂肪及制品
天虹穿线管	钢铁	钢 材、合金钢材	管材及附件
天津港德龙热压铁块	金属矿石	锰矿石	其它
12螺纹	钢铁	钢 材、合金钢材	线材
钢管12米	钢铁	钢 材、合金钢材	管材及附件
螺纹钢HRB400E	钢铁	钢 材、合金钢材	线材
螺纹钢22	钢铁	钢 材、合金钢材	线材
219X65钢管	钢铁	钢 材、合金钢材	管材及附件
螺纹钢	钢铁	钢 材、合金钢材	线材
三级螺纹钢	钢铁	钢 材、合金钢材	线材
三级螺纹钢14mm	钢铁	钢 材、合金钢材	线材
三级螺纹钢12mm	钢铁	钢 材、合金钢材	线材
HRB400E18螺纹	钢铁	钢 材、合金钢材	线材
12螺纹16吨	钢铁	钢 材、合金钢材	线材
14螺纹	钢铁	钢 材、合金钢材	线材
螺纹钢18	钢铁	钢 材、合金钢材	线材
螺纹	钢铁	钢 材、合金钢材	线材
钢管	钢铁	钢 材、合金钢材	管材及附件
HRB400螺纹25	钢铁	钢 材、合金钢材	线材
螺纹钢25	钢铁	钢 材、合金钢材	线材
螺纹钢20	钢铁	钢 材、合金钢材	线材
三级螺纹钢10盘螺	钢铁	钢 材、合金钢材	线材
25三级抗震螺纹钢	钢铁	钢 材、合金钢材	线材
20三级螺纹钢	钢铁	钢 材、合金钢材	线材
14三级螺纹钢	钢铁	钢 材、合金钢材	线材
14三级抗震螺纹钢	钢铁	钢 材、合金钢材	线材
螺纹钢32HRB400	钢铁	钢 材、合金钢材	线材
四级抗震螺纹钢18	钢铁	钢 材、合金钢材	线材
四级抗震螺纹钢20	钢铁	钢 材、合金钢材	线材
四级抗震螺纹钢25	钢铁	钢 材、合金钢材	线材
三级螺纹钢25	钢铁	钢 材、合金钢材	线材
三级螺纹钢18	钢铁	钢 材、合金钢材	线材
三级抗震螺纹钢12	钢铁	钢 材、合金钢材	线材
三级抗震螺纹钢18	钢铁	钢 材、合金钢材	线材
三级抗震螺纹钢20	钢铁	钢 材、合金钢材	线材
三级抗震螺纹钢22	钢铁	钢 材、合金钢材	线材
三级抗震螺纹钢25	钢铁	钢 材、合金钢材	线材
钢板中板	钢铁	钢 材、合金钢材	板材
18螺纹	钢铁	钢 材、合金钢材	线材
25螺纹	钢铁	钢 材、合金钢材	线材
20螺纹	钢铁	钢 材、合金钢材	线材
22螺纹	钢铁	钢 材、合金钢材	线材
螺纹钢12	钢铁	钢 材、合金钢材	线材
螺纹钢14	钢铁	钢 材、合金钢材	线材
螺纹钢16	钢铁	钢 材、合金钢材	线材
16螺纹	钢铁	钢 材、合金钢材	线材
螺纹钢32	钢铁	钢 材、合金钢材	线材
螺纹钢28	钢铁	钢 材、合金钢材	线材
卷材	钢铁	钢 材、合金钢材	卷材
三级螺纹钢20	钢铁	钢 材、合金钢材	线材
三级螺纹钢14	钢铁	钢 材、合金钢材	线材
日用百货	轻工、医药产品	日用工业品	其它日用品
惠美家肉香料酒	轻工、医药产品	饮食品	其它未列名饮食及调味食品
螺纹12	钢铁	钢 材、合金钢材	线材
螺纹14	钢铁	钢 材、合金钢材	线材
螺纹16	钢铁	钢 材、合金钢材	线材
螺纹10	钢铁	钢 材、合金钢材	线材
螺纹20	钢铁	钢 材、合金钢材	线材
无缝钢32	钢铁	钢 材、合金钢材	管材及附件
无缝钢273	钢铁	钢 材、合金钢材	管材及附件
牛奶	轻工、医药产品	饮食品	乳制品，蜂蜜、王浆、粉
酒	轻工、医药产品	饮食品	酒（白酒、啤酒、果酒类）
铜锭	轻工、医药产品	工艺美术品	普通金属工艺品
螺纹钢122	钢铁	钢 材、合金钢材	线材
60克轻型胶版纸	轻工、医药产品	纸及制品(十类)	机制纸（新闻纸）
68克胶原版印刷纸	轻工、医药产品	纸及制品(十类)	机制纸（新闻纸）
55克期刊杂志纸	轻工、医药产品	饮食品	其它
热轧卷	钢铁	钢 材、合金钢材	卷材
卷筒纸	轻工、医药产品	纸及制品(十类)	乳制品，蜂蜜、王浆、粉
天赐缘酒水	轻工、医药产品	饮食品	酒（白酒、啤酒、果酒类）
卷纸	其它货类	纸及制品(十类)	其它
纸浆	轻工、医药产品	纸及制品(十类)	纸浆
无缝钢管	钢铁	钢 材、合金钢材	管材及附件
150钢板桩	钢铁	钢 材、合金钢材	板材
成品卷筒纸	轻工、医药产品	纸及制品(十类)	机制纸（新闻纸）
70克轻型胶版纸	轻工、医药产品	纸及制品(十类)	机制纸（新闻纸）
65克轻型胶版纸765	轻工、医药产品	纸及制品(十类)	机制纸（新闻纸）
55克轻型胶版纸765	轻工、医药产品	纸及制品(十类)	机制纸（新闻纸）
55克胶印书刊纸	轻工、医药产品	文化体育用品	印刷品
78克轻型胶版纸	轻工、医药产品	纸及制品(十类)	机制纸（新闻纸）
55克轻型胶版纸	轻工、医药产品	纸及制品(十类)	机制纸（新闻纸）
68克轻型胶版纸	轻工、医药产品	纸及制品(十类)	机制纸（新闻纸）
67克离型原纸深黄	轻工、医药产品	纸及制品(十类)	纸板（原纸）
60克胶印书刊纸	轻工、医药产品	文化体育用品	印刷品
核电钢板	钢铁	钢 材、合金钢材	板材
钢立柱	钢铁	钢铁制品	钢铁材料、结构体
53克胶印书刊纸	轻工、医药产品	文化体育用品	印刷品
80克轻型胶版纸	轻工、医药产品	纸及制品(十类)	机制纸（新闻纸）
65克轻型胶版纸	轻工、医药产品	纸及制品(十类)	机制纸（新闻纸）
65克离型原纸深黄	轻工、医药产品	纸及制品(十类)	纸板（原纸）
70克离型原纸深黄	轻工、医药产品	纸及制品(十类)	纸板（原纸）
球扁钢角钢L型钢船用型材	钢铁	钢 材、合金钢材	型材
60克热敏原纸	轻工、医药产品	纸及制品(十类)	其它纸及制品
68克离型原纸1300	轻工、医药产品	纸及制品(十类)	纸板（原纸）
电箱	机械设备、电器	电子、电讯设备及器材	电子、光、磁、超声波装置的元器件、零件、附件
67克离型原纸1028深黄	轻工、医药产品	纸及制品(十类)	纸板（原纸）
118克相册原纸	轻工、医药产品	纸及制品(十类)	其它纸及制品
98克相册原纸	轻工、医药产品	纸及制品(十类)	其它纸及制品
发动机	钢铁	钢 材、合金钢材	管材及附件
67克轻型胶版纸	轻工、医药产品	纸及制品(十类)	机制纸（新闻纸）
连铸圆坯	钢铁	钢 材、合金钢材	线材
50克胶印书刊纸	轻工、医药产品	文化体育用品	印刷品
洗衣机	机械设备、电器	电力设备、电器机械及器材	家用电器
58克轻型胶版纸	轻工、医药产品	纸及制品(十类)	机制纸（新闻纸）
57克轻型胶版纸	轻工、医药产品	纸及制品(十类)	机制纸（新闻纸）
73克离型原纸	轻工、医药产品	纸及制品(十类)	纸板（原纸）
70克离型原纸	轻工、医药产品	纸及制品(十类)	纸板（原纸）
68克离型原纸	轻工、医药产品	纸及制品(十类)	纸板（原纸）
70克离型原纸浅黄	轻工、医药产品	纸及制品(十类)	纸板（原纸）
75克离型原纸	轻工、医药产品	纸及制品(十类)	纸板（原纸）
油剂	化工原料及制品	其它未列名化工原料及制品	钢铁容器
小叶浆	轻工、医药产品	纸及制品(十类)	纸浆
100克染色原纸	轻工、医药产品	纸及制品(十类)	纸板（原纸）
罐子	轻工、医药产品	竹、木、藤、花、草	竹
118克轻型胶版纸	轻工、医药产品	纸及制品(十类)	机制纸（新闻纸）
41克离型原纸	轻工、医药产品	纸及制品(十类)	纸板（原纸）
电气柜	机械设备、电器	电力设备、电器机械及器材	家用电器
钢板桩	钢铁	钢 材、合金钢材	板材
小叶	轻工、医药产品	其它	其它
三级抗震螺纹钢	钢铁	钢 材、合金钢材	线材
双胶纸	轻工、医药产品	纸及制品(十类)	其它纸及制品
轻型纸	轻工、医药产品	纸及制品(十类)	其它纸及制品
更衣柜 20*20*20  7	轻工、医药产品	针织、纺织、皮毛及制品	服装
螺纹20*20*20  8	钢铁	钢 材、合金钢材	线材
螺纹20*20*20  9	钢铁	钢 材、合金钢材	线材
钢管20*20*20  10	钢铁	钢 材、合金钢材	管材及附件
钢管20*20*20  11	钢铁	钢 材、合金钢材	管材及附件
三级螺纹钢10	钢铁	钢 材、合金钢材	线材
短纤	轻工、医药产品	针织、纺织、皮毛及制品	纱、线、丝、纤维（非复合材料）
静电纸	轻工、医药产品	纸及制品(十类)	纸板（原纸）
果糖	轻工、医药产品	饮食品	糖（固体、浆）
镀锌带钢	钢铁	钢铁制品	钢铁件及其它五金制品
镀锌角钢	钢铁	钢 材、合金钢材	型材
葡糖糖	轻工、医药产品	饮食品	糖（固体、浆）
钢带	钢铁	钢铁制品	钢铁件及其它五金制品
42克离型原纸	轻工、医药产品	纸及制品(十类)	纸板（原纸）
钢筋	钢铁	钢 材、合金钢材	线材
100克离型原纸	轻工、医药产品	纸及制品(十类)	纸板（原纸）
58克胶印书刊纸	轻工、医药产品	文化体育用品	印刷品
50克离型原纸	轻工、医药产品	纸及制品(十类)	纸板（原纸）
减震器	机械设备、电器	普通工业机械及设备	通用设备
黑角钢	钢铁	钢 材、合金钢材	型材
空罐子	轻工、医药产品	日用工业品	其它日用品
牛仔布	轻工、医药产品	针织、纺织、皮毛及制品	皮毛制品
镀锌板	钢铁	钢 材、合金钢材	板材
糖化酶	轻工、医药产品	饮食品	糖（固体、浆）
50KG包装盐	轻工、医药产品	饮食品	动植物食用油料、脂肪及制品
彩钢板	钢铁	钢 材、合金钢材	板材
机油	机械设备、电器	交通运输设备	其它
润滑油	农、林、牧、渔业产品	经济作物及制品	动植物食用油料、脂肪及制品
洗衣液	轻工、医药产品	日用工业品	其它日用品
热镀管加螺旋管	钢铁	钢 材、合金钢材	管材及附件
管件	钢铁	钢 材、合金钢材	钢铁材料、结构体
方矩管热镀方矩管	钢铁	钢 材、合金钢材	管材及附件
打印机	机械设备、电器	电子、电讯设备及器材	电子计算机及外部设备
发方矩管	钢铁	钢 材、合金钢材	管材及附件
板材水陆联运	机械设备、电器	专用机械、设备及制品	其它
热镀方管	钢铁	钢 材、合金钢材	管材及附件
液氮油	化工原料及制品	其它未列名化工原料及制品	其它
柜台	轻工、医药产品	电力设备、电器机械及器材	纸板（原纸）
岩棉	轻工、医药产品	针织、纺织、皮毛及制品	布匹（机织、绒织、网织物、纱罗）
面包机	轻工、医药产品	日用工业品	其它日用品
钛钽矿	金属矿石	铁矿石	其它
方矩管直发江宁	钢铁	钢 材、合金钢材	管材及附件
方矩管直发谷里	钢铁	钢 材、合金钢材	管材及附件
镀锌角槽	钢铁	钢 材、合金钢材	型材
石材	钢铁	钢 材、合金钢材	管材及附件
集装箱	机械设备、电器	交通运输设备	其它运输辅件及器材
榨菜	农、林、牧、渔业产品	蔬菜、瓜果及籽实籽仁	蔬菜
镀锌焊管	钢铁	钢 材、合金钢材	管材及附件
热镀管焊管钢塑管	钢铁	钢 材、合金钢材	管材及附件
冷轧	钢铁	钢 材、合金钢材	其它
热镀方管黑方管	钢铁	钢 材、合金钢材	管材及附件
热镀方矩管方矩管	钢铁	钢 材、合金钢材	管材及附件
污水处理器	机械设备、电器	电力设备、电器机械及器材	通用设备
罐头新货场四条到天鹏	轻工、医药产品	饮食品	其它未列名饮食及调味食品
壁挂炉	轻工、医药产品	饮食品	饮料、果菜汁
光缆	机械设备、电器	电子、电讯设备及器材	电子、光、磁、超声波装置的元器件、零件、附件
开关	钢铁	钢铁制品	管材及附件
食品添加剂	化工原料及制品	其它未列名化工原料及制品	其它
如意双胶纸	轻工、医药产品	纸及制品(十类)	纸板（原纸）
米黄双胶纸	轻工、医药产品	纸及制品(十类)	其它未列名饮食及调味食品
皓月双胶纸	轻工、医药产品	纸及制品(十类)	其它
静电复印原纸	轻工、医药产品	文化体育用品	家具、坐具
如意静电复印原纸	轻工、医药产品	纸及制品(十类)	玻璃制品
瑞雪静电复印纸	轻工、医药产品	日用工业品	其它日用品
瑞雪静电复印原纸	轻工、医药产品	日用工业品	其它日用品
20万吨双胶纸	轻工、医药产品	纸及制品(十类)	其它
如意米黄双胶纸	轻工、医药产品	纸及制品(十类)	其它
胶版纸	轻工、医药产品	纸及制品(十类)	机制纸（新闻纸）
华章轻型纸	轻工、医药产品	日用工业品	家具、坐具
如意静电复印纸	轻工、医药产品	纸及制品(十类)	玻璃制品
热镀加工件	钢铁	钢 材、合金钢材	管材及附件
双胶纸皓月	轻工、医药产品	纸及制品(十类)	机制纸（新闻纸）
油知	轻工、医药产品	日用工业品	钢铁容器
市场流通板船运	钢铁	钢 材、合金钢材	板材
二氧化碳压缩机	轻工、医药产品	日用工业品	文教办公用品
橡胶助剂	化工原料及制品	橡胶	天然橡胶
热镀管方矩管	钢铁	钢 材、合金钢材	管材及附件
热镀管螺旋管	钢铁	钢 材、合金钢材	管材及附件
70克皓月双胶纸	轻工、医药产品	纸及制品(十类)	其它
80克皓月双胶纸	轻工、医药产品	纸及制品(十类)	其它
60克如意双胶纸	轻工、医药产品	纸及制品(十类)	纸板（原纸）
58克如意双胶纸	轻工、医药产品	纸及制品(十类)	纸板（原纸）
68克如意双胶纸	轻工、医药产品	纸及制品(十类)	纸板（原纸）
热镀管螺旋	钢铁	钢 材、合金钢材	管材及附件
瑞雪静电纸	轻工、医药产品	日用工业品	其它日用品
热镀园管	钢铁	钢 材、合金钢材	管材及附件
焊热镀	钢铁	钢 材、合金钢材	管材及附件
瑞雪复印纸	轻工、医药产品	文化体育用品	文教办公用品
日用品	轻工、医药产品	日用工业品	卫生品(洗涤剂、皂类)
盘螺螺纹钢	钢铁	钢 材、合金钢材	线材
教辅轻型纸	轻工、医药产品	日用工业品	家具、坐具
豆粕	粮食	杂粮	杂豆
饼干	轻工、医药产品	饮食品	其它未列名饮食及调味食品
材料	金属矿石	铁矿石	其它
热镀立柱小件	钢铁	钢铁制品	钢铁材料、结构体
护栏材料热镀立柱	钢铁	钢 材、合金钢材	管材及附件
焊管热镀管发定西	钢铁	钢 材、合金钢材	管材及附件
热镀制品方管	钢铁	钢 材、合金钢材	管材及附件
热镀制品	钢铁	钢 材、合金钢材	管材及附件
热镀管德清	钢铁	钢 材、合金钢材	管材及附件
螺旋管热镀管	钢铁	钢 材、合金钢材	管材及附件
微波炉PC160830000039	机械设备、电器	电力设备、电器机械及器材	钢铁容器
PC160831000081微波炉	机械设备、电器	电力设备、电器机械及器材	钢铁容器
钢板水陆联运车板交货	钢铁	钢 材、合金钢材	板材
热镀立柱	钢铁	钢铁制品	钢铁材料、结构体
PC160908000053微波炉	机械设备、电器	电力设备、电器机械及器材	钢铁容器
PC160908000036微波炉	机械设备、电器	电力设备、电器机械及器材	钢铁容器
PC160908000078微波炉	机械设备、电器	电力设备、电器机械及器材	钢铁容器
PC160830000039微波炉	机械设备、电器	电力设备、电器机械及器材	钢铁容器
PC160908000066卷纸	其它货类	纸及制品(十类)	其它
热镀方矩管热镀管	钢铁	钢 材、合金钢材	管材及附件
热镀管热镀方矩管	钢铁	钢 材、合金钢材	管材及附件
方矩热镀管	钢铁	钢 材、合金钢材	管材及附件
方矩热镀管热镀管	钢铁	钢 材、合金钢材	管材及附件
PC160909000059卷纸	其它货类	纸及制品(十类)	其它
PC160910000046微波炉	机械设备、电器	电力设备、电器机械及器材	钢铁容器
PC160911000023卷纸	其它货类	纸及制品(十类)	其它
PC160911000014卷纸	其它货类	纸及制品(十类)	其它
PC160912000062卷纸	其它货类	纸及制品(十类)	其它
热镀管吴江	钢铁	钢 材、合金钢材	管材及附件
PC160913000042微波炉	机械设备、电器	电力设备、电器机械及器材	钢铁容器
PC160913000039微波炉	机械设备、电器	电力设备、电器机械及器材	钢铁容器
热镀方矩管松江区	钢铁	钢 材、合金钢材	管材及附件
PC160913000086卷纸	其它货类	纸及制品(十类)	其它
PC160913000085卷纸	其它货类	纸及制品(十类)	其它
PC160913000084卷纸	其它货类	纸及制品(十类)	其它
PC160914000016微波炉	机械设备、电器	电力设备、电器机械及器材	钢铁容器
热镀方矩	钢铁	钢 材、合金钢材	管材及附件
PC160914000033卷纸	其它货类	纸及制品(十类)	其它
PC160914000015洗衣机	机械设备、电器	电力设备、电器机械及器材	家用电器
PC160915000014微波炉	机械设备、电器	电力设备、电器机械及器材	钢铁容器
方矩热镀官	钢铁	钢 材、合金钢材	管材及附件
热镀方矩管必须盖雨布	钢铁	钢 材、合金钢材	管材及附件
PC160916000005卷纸	其它货类	纸及制品(十类)	其它
PC160916000004卷纸	其它货类	纸及制品(十类)	其它
PC160916000016微波炉	机械设备、电器	电力设备、电器机械及器材	钢铁容器
PC160917000008卷纸	其它货类	纸及制品(十类)	其它
PC160916000017微波炉	机械设备、电器	电力设备、电器机械及器材	钢铁容器
PC160917000133微波炉	机械设备、电器	电力设备、电器机械及器材	钢铁容器
18670562933新闻纸	轻工、医药产品	纸及制品(十类)	其它纸及制品
PC160917000086新闻纸	轻工、医药产品	纸及制品(十类)	其它纸及制品
PC160918000031卷纸	其它货类	纸及制品(十类)	其它
热镀管宝山	钢铁	钢 材、合金钢材	管材及附件
热镀管松江	钢铁	钢 材、合金钢材	管材及附件
PC160919000057新闻纸	轻工、医药产品	纸及制品(十类)	其它纸及制品
零件	机械设备、电器	普通工业机械及设备	金属加工机械及设备
焊管热镀管发聊城	钢铁	钢 材、合金钢材	管材及附件
热镀管松江区	钢铁	钢 材、合金钢材	管材及附件
PC160919000066卷纸	其它货类	纸及制品(十类)	其它
热镀管淮北濉溪	钢铁	钢 材、合金钢材	管材及附件
热镀管嘉定区	钢铁	钢 材、合金钢材	管材及附件
热镀管渭南	钢铁	钢 材、合金钢材	管材及附件
热镀管廉江市良垌镇	钢铁	钢 材、合金钢材	管材及附件
热镀管杭州	钢铁	钢 材、合金钢材	管材及附件
热镀方矩管宝山区	钢铁	钢 材、合金钢材	管材及附件
热镀管阜阳	钢铁	钢 材、合金钢材	管材及附件
热镀管阜阳太和	钢铁	钢 材、合金钢材	管材及附件
热镀管淮北	钢铁	钢 材、合金钢材	管材及附件
PC160921000020微波炉	机械设备、电器	电力设备、电器机械及器材	钢铁容器
热镀管奉贤	钢铁	钢 材、合金钢材	管材及附件
310吨复合钢板船运水陆联运	钢铁	钢 材、合金钢材	板材
热镀方矩管宝山	钢铁	钢 材、合金钢材	管材及附件
PC160921000056卷纸	其它货类	纸及制品(十类)	其它
热镀方矩管松江	钢铁	钢 材、合金钢材	管材及附件
热镀方矩管嘉定	钢铁	钢 材、合金钢材	管材及附件
热镀方矩管奉贤区	钢铁	钢 材、合金钢材	管材及附件
热镀管奉贤区	钢铁	钢 材、合金钢材	管材及附件
热镀管浦东	钢铁	钢 材、合金钢材	管材及附件
热镀管芜湖	钢铁	钢 材、合金钢材	管材及附件
路灯	轻工、医药产品	日用工业品	灯具、照明装置、发光标志、牌照
PC160922000043微波炉	机械设备、电器	电力设备、电器机械及器材	钢铁容器
310吨复合钢板	钢铁	钢 材、合金钢材	板材
油箱	机械设备、电器	电力设备、电器机械及器材	家用电器
热镀方矩管订货	钢铁	钢 材、合金钢材	管材及附件
PC160923000028卷纸	其它货类	纸及制品(十类)	其它
PC160923000090微波炉	机械设备、电器	电力设备、电器机械及器材	钢铁容器
热镀方矩管浦东区	钢铁	钢 材、合金钢材	管材及附件
热镀管常州	钢铁	钢 材、合金钢材	管材及附件
热镀管河南康华	钢铁	钢 材、合金钢材	管材及附件
上海丽瑜热镀方矩管	轻工、医药产品	工艺美术品	纸浆
PC160923000030卷纸	其它货类	纸及制品(十类)	其它
热镀管苏州许氏	钢铁	钢 材、合金钢材	管材及附件
杭州热镀方矩管	钢铁	钢 材、合金钢材	管材及附件
热镀管扬州文轩	钢铁	钢 材、合金钢材	管材及附件
热镀管苏州工业园	钢铁	钢 材、合金钢材	管材及附件
热镀管两磅合肥	钢铁	钢 材、合金钢材	管材及附件
热镀管苏州	钢铁	钢 材、合金钢材	管材及附件
热镀管苏州盛益	钢铁	钢 材、合金钢材	管材及附件
PC160924000058卷纸	其它货类	纸及制品(十类)	其它
PC160924000056微波炉	机械设备、电器	电力设备、电器机械及器材	钢铁容器
PC160926000108卷纸	其它货类	纸及制品(十类)	其它
52克离型原纸	轻工、医药产品	纸及制品(十类)	纸板（原纸）
湖南省恒俊热镀方矩管	化工原料及制品	钢铁制品	电子、光、磁、超声波装置的元器件、零件、附件
湖南文思昌热镀方矩管	轻工、医药产品	日用工业品	卫生品(洗涤剂、皂类)
青岛北方热镀管	轻工、医药产品	工艺美术品	雕塑、刻、漆工艺品
糖果	轻工、医药产品	饮食品	糖果、蜜饯、果脯
PC160927000083微波炉	机械设备、电器	电力设备、电器机械及器材	钢铁容器
PC160928000064微波炉	机械设备、电器	电力设备、电器机械及器材	钢铁容器
PC160928000086卷纸	其它货类	纸及制品(十类)	其它
PC160929000116微波炉	机械设备、电器	电力设备、电器机械及器材	钢铁容器
热镀方矩管泰安鹏德	钢铁	钢 材、合金钢材	管材及附件
PC160929000098卷纸	其它货类	纸及制品(十类)	其它
太原恒帅热镀管	钢铁	钢 材、合金钢材	管材及附件
泰安东盛恒天热镀管	钢铁	钢 材、合金钢材	管材及附件
镀锌方管带钢	钢铁	钢 材、合金钢材	管材及附件
热镀管杭州万盛	钢铁	钢 材、合金钢材	管材及附件
PC160930000113微波炉	机械设备、电器	电力设备、电器机械及器材	钢铁容器
PC161001000036微波炉	机械设备、电器	电力设备、电器机械及器材	钢铁容器
太原亨旺热镀螺旋	轻工、医药产品	饮食品	雕塑、刻、漆工艺品
热镀管泰安	钢铁	钢 材、合金钢材	管材及附件
PC161002000001卷纸	其它货类	纸及制品(十类)	其它
PC161004000041微波炉	机械设备、电器	电力设备、电器机械及器材	钢铁容器
PC161003000002微波炉	机械设备、电器	电力设备、电器机械及器材	钢铁容器
PC161003000003微波炉	机械设备、电器	电力设备、电器机械及器材	钢铁容器
PC161004000056微波炉	机械设备、电器	电力设备、电器机械及器材	钢铁容器
PC161003000054微波炉	机械设备、电器	电力设备、电器机械及器材	钢铁容器
PC161003000041微波炉	机械设备、电器	电力设备、电器机械及器材	钢铁容器
PC161004000054卷纸	其它货类	纸及制品(十类)	其它
80克轻型胶版纸710	轻工、医药产品	纸及制品(十类)	机制纸（新闻纸）
热镀管聊城	钢铁	钢 材、合金钢材	管材及附件
PC161005000038卷纸	其它货类	纸及制品(十类)	其它
PC161005000041卷纸	其它货类	纸及制品(十类)	其它
PC161005000023微波炉	机械设备、电器	电力设备、电器机械及器材	钢铁容器
PC161006000015卷纸	其它货类	纸及制品(十类)	其它
焊管热镀管	钢铁	钢 材、合金钢材	管材及附件
方矩管	钢铁	钢 材、合金钢材	管材及附件
65克胶印书刊纸770	轻工、医药产品	文化体育用品	印刷品
PC161007000006卷纸	其它货类	纸及制品(十类)	其它
PC161007000008卷纸	其它货类	纸及制品(十类)	其它
PC161008000015微波炉	机械设备、电器	电力设备、电器机械及器材	钢铁容器
55克胶印书刊纸787	轻工、医药产品	文化体育用品	印刷品
PC161008000019卷纸	其它货类	纸及制品(十类)	其它
PC161008000018卷纸	其它货类	纸及制品(十类)	其它
热镀方矩管长沙	钢铁	钢 材、合金钢材	管材及附件
PC161008000045微波炉	机械设备、电器	电力设备、电器机械及器材	钢铁容器
70克轻型胶版纸787	轻工、医药产品	纸及制品(十类)	机制纸（新闻纸）
70克制轻量涂布纸	轻工、医药产品	纸及制品(十类)	纸制品
55克胶印书刊纸730	轻工、医药产品	文化体育用品	印刷品
螺旋加热镀	钢铁	钢 材、合金钢材	管材及附件
热镀加黑方	钢铁	钢 材、合金钢材	管材及附件
78克轻型胶版纸889	轻工、医药产品	纸及制品(十类)	机制纸（新闻纸）
55克胶印书刊纸760	轻工、医药产品	文化体育用品	印刷品
上海振通热镀管松江区	钢铁	钢 材、合金钢材	型材
55克期刊杂志纸770	轻工、医药产品	饮食品	其它
55胶印书刊纸	轻工、医药产品	文化体育用品	印刷品
41克离型原纸1720	轻工、医药产品	纸及制品(十类)	纸板（原纸）
上海姜荣方管发浦东	轻工、医药产品	工艺美术品	纸浆
蓝标胶版纸	轻工、医药产品	纸及制品(十类)	机制纸（新闻纸）
PC161009000043卷纸	其它货类	纸及制品(十类)	其它
PC161009000044卷纸	其它货类	纸及制品(十类)	其它
60克轻型胶版纸787	轻工、医药产品	纸及制品(十类)	机制纸（新闻纸）
太原恒帅热镀	钢铁	钢 材、合金钢材	管材及附件
常州承乾热镀	钢铁	钢 材、合金钢材	管材及附件
聊城鑫辰热镀	钢铁	铁矿石	管材及附件
PC161010000008卷纸	其它货类	纸及制品(十类)	其它
PC161010000009卷纸	其它货类	纸及制品(十类)	其它
热镀管滁州	钢铁	钢 材、合金钢材	管材及附件
纱布	轻工、医药产品	针织、纺织、皮毛及制品	纱、线、丝、纤维（非复合材料）
55克胶印书刊纸660	轻工、医药产品	文化体育用品	印刷品
镀热镀管	钢铁	钢 材、合金钢材	管材及附件
PC161011000082微波炉	机械设备、电器	电力设备、电器机械及器材	钢铁容器
PC161010000011卷纸	其它货类	纸及制品(十类)	其它
PC161011000008卷纸	其它货类	纸及制品(十类)	其它
PC161011000009卷纸	其它货类	纸及制品(十类)	其它
胶布	轻工、医药产品	针织、纺织、皮毛及制品	其它纸及制品
热镀管宿州	钢铁	钢 材、合金钢材	管材及附件
热圆发常州	钢铁	钢 材、合金钢材	管材及附件
发松江热方	钢铁	钢 材、合金钢材	管材及附件
PC161012000124微波炉	机械设备、电器	电力设备、电器机械及器材	钢铁容器
PC161012000158微波炉	机械设备、电器	电力设备、电器机械及器材	钢铁容器
PC161012000076卷纸	其它货类	纸及制品(十类)	其它
纸箱纸箱	轻工、医药产品	纸及制品(十类)	其它纸及制品
PC161013000101微波炉	机械设备、电器	电力设备、电器机械及器材	钢铁容器
60克胶印书刊纸870	轻工、医药产品	文化体育用品	印刷品
PC161014000040微波炉	机械设备、电器	电力设备、电器机械及器材	钢铁容器
真空食品	轻工、医药产品	饮食品	其它未列名饮食及调味食品
PC161015000029型材圆铸锭	钢铁	钢 材、合金钢材	线材
PC161015000030型材圆铸锭	钢铁	钢 材、合金钢材	线材
78轻型胶版纸990	轻工、医药产品	纸及制品(十类)	机制纸（新闻纸）
78轻型胶版纸711	轻工、医药产品	纸及制品(十类)	机制纸（新闻纸）
PC161014000102型材圆铸锭	钢铁	钢 材、合金钢材	线材
螺旋热镀	钢铁	钢 材、合金钢材	管材及附件
热镀管泰安天虹	钢铁	钢 材、合金钢材	管材及附件
64克三防热敏原纸	钢铁	钢 材、合金钢材	管材及附件
PC161014000105卷纸	其它货类	纸及制品(十类)	其它
55克胶印书刊纸880	轻工、医药产品	文化体育用品	印刷品
PC161017000002卷纸	其它货类	纸及制品(十类)	其它
55克胶印书刊纸770	轻工、医药产品	文化体育用品	印刷品
70克象牙白390	轻工、医药产品	纸及制品(十类)	机制纸（新闻纸）
青岛东鑫热镀	钢铁	钢铁制品	其它
73克离型原纸1098	轻工、医药产品	纸及制品(十类)	纸板（原纸）
PC161017000005微波炉	机械设备、电器	电力设备、电器机械及器材	钢铁容器
65克胶印书刊纸1储运	轻工、医药产品	文化体育用品	印刷品
PC161018000011卷纸	其它货类	纸及制品(十类)	其它
73克离型原纸1100	轻工、医药产品	纸及制品(十类)	纸板（原纸）
昆山浩元热镀管	金属矿石	铁矿石	其它
泰安鹏德热镀	钢铁	钢 材、合金钢材	管材及附件
PC161018000031微波炉	机械设备、电器	电力设备、电器机械及器材	钢铁容器
PC161018000030微波炉	机械设备、电器	电力设备、电器机械及器材	钢铁容器
PC161017000001卷纸	其它货类	纸及制品(十类)	其它
发长沙思远热方	钢铁	钢 材、合金钢材	管材及附件
41离型原纸	轻工、医药产品	纸及制品(十类)	纸板（原纸）
泰安东盛恒天1车热镀	钢铁	钢 材、合金钢材	管材及附件
城阳来1车热镀32吨	机械设备、电器	其它未列名矿建材料	制冷、加热、燃烧设备
油箱油	机械设备、电器	普通工业机械及设备	家用电器
泰安德信热镀管	钢铁	钢铁制品	型材
泰安东盛恒热镀管	钢铁	钢 材、合金钢材	管材及附件
i石材	钢铁	钢 材、合金钢材	管材及附件
PC161019000001卷纸	其它货类	纸及制品(十类)	其它
如意静电纸	轻工、医药产品	纸及制品(十类)	玻璃制品
铜箔	有色金属	铜	铜型、线材、异型材及附件
PC161019000036型材圆铸锭	钢铁	钢 材、合金钢材	线材
PC161019000037型材圆铸锭	钢铁	钢 材、合金钢材	线材
PC161019000117微波炉	机械设备、电器	电力设备、电器机械及器材	钢铁容器
PC161019000123微波炉	机械设备、电器	电力设备、电器机械及器材	钢铁容器
70克离型原纸1095	轻工、医药产品	纸及制品(十类)	纸板（原纸）
PC161019000118微波炉	机械设备、电器	电力设备、电器机械及器材	钢铁容器
PC161020000004微波炉	机械设备、电器	电力设备、电器机械及器材	钢铁容器
PC161020000037型材圆铸锭	钢铁	钢 材、合金钢材	线材
泰安正大天虹热镀	钢铁	钢 材、合金钢材	管材及附件
PC161020000038卷纸	其它货类	纸及制品(十类)	其它
PC161020000077微波炉	机械设备、电器	电力设备、电器机械及器材	钢铁容器
PC161021000017微波炉	机械设备、电器	电力设备、电器机械及器材	钢铁容器
PC161021000116卷纸	其它货类	纸及制品(十类)	其它
PC161021000090微波炉	机械设备、电器	电力设备、电器机械及器材	钢铁容器
PC161021000117卷纸	其它货类	纸及制品(十类)	其它
PC161021000095微波炉	机械设备、电器	电力设备、电器机械及器材	钢铁容器
PC161021000093微波炉	机械设备、电器	电力设备、电器机械及器材	钢铁容器
PC161022000012型材圆铸锭	钢铁	钢 材、合金钢材	线材
PC161022000011型材圆铸锭	钢铁	钢 材、合金钢材	线材
PC161022000062微波炉	机械设备、电器	电力设备、电器机械及器材	钢铁容器
PC161022000078微波炉	机械设备、电器	电力设备、电器机械及器材	钢铁容器
PC161022000077微波炉	机械设备、电器	电力设备、电器机械及器材	钢铁容器
PC161022000106卷纸	其它货类	纸及制品(十类)	其它
PC161022000107卷纸	其它货类	纸及制品(十类)	其它
PC161023000030微波炉	机械设备、电器	电力设备、电器机械及器材	钢铁容器
70克轻型胶版纸870	轻工、医药产品	纸及制品(十类)	机制纸（新闻纸）
PC161022000065钢管	钢铁	钢 材、合金钢材	管材及附件
100克染色原纸793	轻工、医药产品	纸及制品(十类)	纸板（原纸）
100克染色原纸893	轻工、医药产品	纸及制品(十类)	纸板（原纸）
68克轻型胶版纸865	轻工、医药产品	纸及制品(十类)	机制纸（新闻纸）
蓝标双胶纸	轻工、医药产品	其它未列名化工原料及制品	其它
60克胶印书刊纸880	轻工、医药产品	文化体育用品	印刷品
70克离型原纸1028	轻工、医药产品	纸及制品(十类)	纸板（原纸）
PC161024000067卷纸	其它货类	纸及制品(十类)	其它
60克胶印书刊纸780	轻工、医药产品	文化体育用品	印刷品
60克胶印书刊纸770	轻工、医药产品	文化体育用品	印刷品
PC161024000071微波炉	机械设备、电器	电力设备、电器机械及器材	钢铁容器
PC161024000072微波炉	机械设备、电器	电力设备、电器机械及器材	钢铁容器
PC161024000073微波炉	机械设备、电器	电力设备、电器机械及器材	钢铁容器
PC161024000074微波炉	机械设备、电器	电力设备、电器机械及器材	钢铁容器
PC161024000075微波炉	机械设备、电器	电力设备、电器机械及器材	钢铁容器
PC161024000077微波炉	机械设备、电器	电力设备、电器机械及器材	钢铁容器
PC161024000080微波炉	机械设备、电器	电力设备、电器机械及器材	钢铁容器
PC161024000079微波炉	机械设备、电器	电力设备、电器机械及器材	钢铁容器
PC161024000078微波炉	机械设备、电器	电力设备、电器机械及器材	钢铁容器
PC161024000076微波炉	机械设备、电器	电力设备、电器机械及器材	钢铁容器
PC161025000054微波炉	机械设备、电器	电力设备、电器机械及器材	钢铁容器
70克离型原纸1100	轻工、医药产品	纸及制品(十类)	纸板（原纸）
青岛北方热镀	轻工、医药产品	工艺美术品	雕塑、刻、漆工艺品
烟胶片	化工原料及制品	其它未列名化工原料及制品	其它
PC161025000059微波炉	机械设备、电器	电力设备、电器机械及器材	钢铁容器
PC161025000055洗衣机	机械设备、电器	电力设备、电器机械及器材	家用电器
PC161026000008洗衣机	机械设备、电器	电力设备、电器机械及器材	家用电器
PC161026000028卷纸	其它货类	纸及制品(十类)	其它
PC161026000057微波炉	机械设备、电器	电力设备、电器机械及器材	钢铁容器
PC161026000059微波炉	机械设备、电器	电力设备、电器机械及器材	钢铁容器
PC161026000070微波炉	机械设备、电器	电力设备、电器机械及器材	钢铁容器
容器钢板	钢铁	钢 材、合金钢材	板材
杭州热镀	钢铁	钢 材、合金钢材	管材及附件
PC161026000069微波炉	机械设备、电器	电力设备、电器机械及器材	钢铁容器
PC161026000071微波炉	机械设备、电器	电力设备、电器机械及器材	钢铁容器
65克胶印书刊纸	轻工、医药产品	文化体育用品	印刷品
77克轻型胶版纸	轻工、医药产品	纸及制品(十类)	机制纸（新闻纸）
水泥杆	钢铁	钢 材、合金钢材	钢铁件及其它五金制品
泰安东盛恒天热镀加纲塑	钢铁	钢 材、合金钢材	管材及附件
太原恒帅热镀加纲塑	钢铁	钢 材、合金钢材	管材及附件
PC161028000052微波炉	机械设备、电器	电力设备、电器机械及器材	钢铁容器
67克离型原纸	轻工、医药产品	纸及制品(十类)	纸板（原纸）
75克胶印书刊纸914	轻工、医药产品	文化体育用品	印刷品
75克胶印书刊纸881	轻工、医药产品	文化体育用品	印刷品
杭州华龙热方发杭州	钢铁	钢 材、合金钢材	管材及附件
泰安正大热镀	钢铁	钢 材、合金钢材	管材及附件
PC161028000072微波炉	机械设备、电器	电力设备、电器机械及器材	钢铁容器
青岛沃尔富森热镀	机械设备、电器	普通工业机械及设备	家用电器
PC161028000123微波炉	机械设备、电器	电力设备、电器机械及器材	钢铁容器
PC161029000031微波炉	机械设备、电器	电力设备、电器机械及器材	钢铁容器
PC161029000033微波炉	机械设备、电器	电力设备、电器机械及器材	钢铁容器
PC161029000030微波炉	机械设备、电器	电力设备、电器机械及器材	钢铁容器
98克轻型胶版纸	轻工、医药产品	纸及制品(十类)	机制纸（新闻纸）
60克胶印书刊纸956	轻工、医药产品	文化体育用品	印刷品
65克离型原纸	轻工、医药产品	纸及制品(十类)	纸板（原纸）
热镀螺旋南北厂两地卸	钢铁	钢 材、合金钢材	管材及附件
65克复合胶版纸780	轻工、医药产品	纸及制品(十类)	机制纸（新闻纸）
普通热轧卷	钢铁	钢 材、合金钢材	管材及附件
PC161031000019微波炉	机械设备、电器	电力设备、电器机械及器材	钢铁容器
PC161031000020微波炉	机械设备、电器	电力设备、电器机械及器材	钢铁容器
石材磨光机	轻工、医药产品	工艺美术品	道路机动车辆
黑方管热镀管	钢铁	钢 材、合金钢材	管材及附件
教辅专业纸	其它货类	电子、电讯设备及器材	管材及附件
73克离型原纸1300	轻工、医药产品	纸及制品(十类)	纸板（原纸）
PC161031000003微波炉	机械设备、电器	电力设备、电器机械及器材	钢铁容器
泰安东盛热镀	钢铁	钢 材、合金钢材	管材及附件
奶茶果冻	轻工、医药产品	饮食品	其它未列名饮食及调味食品
PC161031000054微波炉	机械设备、电器	电力设备、电器机械及器材	钢铁容器
热镀泰安一闰	钢铁	钢 材、合金钢材	管材及附件
PC161031000055微波炉	机械设备、电器	电力设备、电器机械及器材	钢铁容器
PC161031000057微波炉	机械设备、电器	电力设备、电器机械及器材	钢铁容器
热镀泰安鹏德	钢铁	钢 材、合金钢材	管材及附件
55克轻型胶版纸865	轻工、医药产品	纸及制品(十类)	机制纸（新闻纸）
PC161031000056微波炉	机械设备、电器	电力设备、电器机械及器材	钢铁容器
PC161101000063卷纸	其它货类	纸及制品(十类)	其它
PC161031000045卷纸	其它货类	纸及制品(十类)	其它
PC161031000044卷纸	其它货类	纸及制品(十类)	其它
PC161030000033卷纸	其它货类	纸及制品(十类)	其它
热镀加螺旋	钢铁	钢 材、合金钢材	钢铁件及其它五金制品
盒板	钢铁	钢 材、合金钢材	板材
PC161101000091型材圆铸锭	钢铁	钢 材、合金钢材	线材
PC161101000090型材圆铸锭	钢铁	钢 材、合金钢材	线材
PC161101000071微波炉	机械设备、电器	电力设备、电器机械及器材	钢铁容器
PC161031000084卷纸	其它货类	纸及制品(十类)	其它
PC161101000126微波炉	机械设备、电器	电力设备、电器机械及器材	钢铁容器
68克轻型胶版纸889	轻工、医药产品	纸及制品(十类)	机制纸（新闻纸）
77克轻型胶版纸889	轻工、医药产品	纸及制品(十类)	机制纸（新闻纸）
PC161101000070微波炉	机械设备、电器	电力设备、电器机械及器材	钢铁容器
黑方热镀	钢铁	钢 材、合金钢材	管材及附件
热镀苏州不叉	钢铁	钢 材、合金钢材	管材及附件
41克无炭复写纸	轻工、医药产品	纸及制品(十类)	机制纸（新闻纸）
松江区热镀	钢铁	钢 材、合金钢材	管材及附件
PC161102000008微波炉	机械设备、电器	电力设备、电器机械及器材	钢铁容器
PC161102000014微波炉	机械设备、电器	电力设备、电器机械及器材	钢铁容器
60胶印书刊纸	轻工、医药产品	文化体育用品	印刷品
118克胶印书刊纸	轻工、医药产品	文化体育用品	印刷品
PC161102000086型材圆铸锭	钢铁	钢 材、合金钢材	线材
75克胶印书刊纸770	轻工、医药产品	文化体育用品	印刷品
PC161102000111卷纸	其它货类	纸及制品(十类)	其它
70克离型原纸1550	轻工、医药产品	纸及制品(十类)	纸板（原纸）
电容组架	机械设备、电器	电子、电讯设备及器材	电子、光、磁、超声波装置的元器件、零件、附件
PC161103000040卷纸	其它货类	纸及制品(十类)	其它
PC161103000014微波炉	机械设备、电器	电力设备、电器机械及器材	钢铁容器
PC161103000041微波炉	机械设备、电器	电力设备、电器机械及器材	钢铁容器
PC161103000078微波炉	机械设备、电器	电力设备、电器机械及器材	钢铁容器
方矩管热镀	钢铁	钢 材、合金钢材	管材及附件
80克胶印书刊纸787	轻工、医药产品	文化体育用品	印刷品
60克胶印书刊纸787	轻工、医药产品	文化体育用品	印刷品
泰安东盛天热镀	钢铁	钢 材、合金钢材	管材及附件
PC161104000010微波炉	机械设备、电器	电力设备、电器机械及器材	钢铁容器
晋城洪邦焊管加热镀发普城	钢铁	钢 材、合金钢材	钢铁件及其它五金制品
杭州鲁瑞热方发杭州	轻工、医药产品	饮食品	其它
PC161104000066微波炉	机械设备、电器	电力设备、电器机械及器材	钢铁容器
PC161104000022洗衣机	机械设备、电器	电力设备、电器机械及器材	家用电器
涡阳热镀	钢铁	钢 材、合金钢材	管材及附件
发南通热方	钢铁	钢 材、合金钢材	管材及附件
68克胶印书刊纸850	轻工、医药产品	文化体育用品	印刷品
PC161105000016微波炉	机械设备、电器	电力设备、电器机械及器材	钢铁容器
55克胶印书刊纸870	轻工、医药产品	文化体育用品	印刷品
热镀松江	钢铁	钢 材、合金钢材	管材及附件
PC161105000043卷纸	其它货类	纸及制品(十类)	其它
热镀合肥	钢铁	钢 材、合金钢材	管材及附件
热镀常州	钢铁	钢 材、合金钢材	管材及附件
热镀芜湖	钢铁	钢 材、合金钢材	管材及附件
松江热镀	钢铁	钢 材、合金钢材	管材及附件
热镀方	钢铁	钢 材、合金钢材	管材及附件
吴江热镀	钢铁	钢 材、合金钢材	管材及附件
PC161106000055型材圆铸锭	钢铁	钢 材、合金钢材	线材
PC161106000054型材圆铸锭	钢铁	钢 材、合金钢材	线材
PC161106000090卷纸	其它货类	纸及制品(十类)	其它
PC161107000067微波炉	机械设备、电器	电力设备、电器机械及器材	钢铁容器
PC161107000082微波炉	机械设备、电器	电力设备、电器机械及器材	钢铁容器
PC161107000068微波炉	机械设备、电器	电力设备、电器机械及器材	钢铁容器
PC161107000094卷纸	其它货类	纸及制品(十类)	其它
热镀加吉利	钢铁	钢 材、合金钢材	管材及附件
热镀不叉	钢铁	钢 材、合金钢材	板材
烟片橡胶	化工原料及制品	橡胶	天然橡胶
PC161108000075卷纸	其它货类	纸及制品(十类)	其它
PC161108000074卷纸	其它货类	纸及制品(十类)	其它
螺纹钢盘螺	钢铁	钢 材、合金钢材	线材
白方家热镀	钢铁	钢 材、合金钢材	管材及附件
PC161110000012微波炉	机械设备、电器	电力设备、电器机械及器材	钢铁容器
PC161110000068微波炉	机械设备、电器	电力设备、电器机械及器材	钢铁容器
70克轻型胶版纸781	轻工、医药产品	纸及制品(十类)	机制纸（新闻纸）
70克离型原纸1198	轻工、医药产品	纸及制品(十类)	纸板（原纸）
65克复合胶版纸	轻工、医药产品	纸及制品(十类)	机制纸（新闻纸）
PC161111000059卷纸	其它货类	纸及制品(十类)	其它
汽车玻璃	轻工、医药产品	日用工业品	玻璃制品
热镀蒙城	钢铁	钢 材、合金钢材	管材及附件
阜阳热镀	钢铁	钢 材、合金钢材	管材及附件
52水晶剑	轻工、医药产品	饮食品	饮料、果菜汁
电组架	机械设备、电器	电力设备、电器机械及器材	家用电器
热镀加纲塑	钢铁	钢 材、合金钢材	管材及附件
80克胶印书刊纸880	轻工、医药产品	文化体育用品	印刷品
黑方加热镀	钢铁	钢 材、合金钢材	管材及附件
52水晶剑南春	轻工、医药产品	饮食品	饮料、果菜汁
大理石板材	矿物性建筑材料	钢 材、合金钢材	非合金钢
热镀热镀	钢铁	钢 材、合金钢材	管材及附件
创新豆瓣	轻工、医药产品	针织、纺织、皮毛及制品	服装
豆瓣+样品	轻工、医药产品	杂粮	其它未列名饮食及调味食品
藁城盛邦热镀	钢铁	钢 材、合金钢材	钢铁件及其它五金制品
江西拓诚热镀	钢铁	钢 材、合金钢材	管材及附件
安阳市瑞飞热镀加纲塑	钢铁	钢 材、合金钢材	管材及附件
65克符合胶版纸780	轻工、医药产品	纸及制品(十类)	机制纸（新闻纸）
70克胶印书刊纸	轻工、医药产品	文化体育用品	印刷品
热镀加焊管发洛阳	钢铁	钢 材、合金钢材	管材及附件
55克胶印书刊纸880+1240	轻工、医药产品	文化体育用品	印刷品
60克胶印书刊纸860	轻工、医药产品	文化体育用品	印刷品
58克胶印书刊纸870	轻工、医药产品	文化体育用品	印刷品
方矩管热镀管	钢铁	钢 材、合金钢材	管材及附件
67克离型原纸1550	轻工、医药产品	纸及制品(十类)	纸板（原纸）
65克轻型胶版纸710	轻工、医药产品	纸及制品(十类)	机制纸（新闻纸）
65克轻型胶版纸1010	轻工、医药产品	纸及制品(十类)	机制纸（新闻纸）
65克轻型胶版纸787	轻工、医药产品	纸及制品(十类)	机制纸（新闻纸）
75克轻型胶版纸889	轻工、医药产品	纸及制品(十类)	机制纸（新闻纸）
75克轻型胶版纸	轻工、医药产品	纸及制品(十类)	机制纸（新闻纸）
75克轻型胶版纸880	轻工、医药产品	纸及制品(十类)	机制纸（新闻纸）
75克轻型胶版纸710	轻工、医药产品	纸及制品(十类)	机制纸（新闻纸）
75克轻型胶版纸1000	轻工、医药产品	纸及制品(十类)	机制纸（新闻纸）
热镀濉溪	钢铁	钢 材、合金钢材	管材及附件
60克胶印书刊纸890	轻工、医药产品	文化体育用品	印刷品
70克离型原纸1250	轻工、医药产品	纸及制品(十类)	纸板（原纸）
70克离型原纸1060	轻工、医药产品	纸及制品(十类)	纸板（原纸）
70克离型原纸1198浅黄	轻工、医药产品	纸及制品(十类)	纸板（原纸）
70克离型原纸1198深黄	轻工、医药产品	纸及制品(十类)	纸板（原纸）
70克离型原纸1028深黄	轻工、医药产品	纸及制品(十类)	纸板（原纸）
70克离型原纸1028浅黄	轻工、医药产品	纸及制品(十类)	纸板（原纸）
70克离型原纸1050	轻工、医药产品	纸及制品(十类)	纸板（原纸）
80克离型原纸1145	轻工、医药产品	纸及制品(十类)	纸板（原纸）
70克离型原纸1040	轻工、医药产品	纸及制品(十类)	纸板（原纸）
80克离型原纸1635	轻工、医药产品	纸及制品(十类)	纸板（原纸）
80克离型原纸1410	轻工、医药产品	纸及制品(十类)	纸板（原纸）
80克离型原纸1055	轻工、医药产品	纸及制品(十类)	纸板（原纸）
80克离型原纸1110	轻工、医药产品	纸及制品(十类)	纸板（原纸）
100克离型原纸1075	轻工、医药产品	纸及制品(十类)	纸板（原纸）
120克离型原纸1075	轻工、医药产品	纸及制品(十类)	纸板（原纸）
120克离型原纸1250	轻工、医药产品	纸及制品(十类)	纸板（原纸）
45克无炭复写纸	轻工、医药产品	纸及制品(十类)	机制纸（新闻纸）
80克胶印书刊纸780	轻工、医药产品	文化体育用品	印刷品
焊管热镀发安阳	钢铁	钢 材、合金钢材	管材及附件
111克相册原纸1070	轻工、医药产品	纸及制品(十类)	其它纸及制品
118克相册原纸1070	轻工、医药产品	纸及制品(十类)	其它纸及制品
98克相册原纸1070	轻工、医药产品	纸及制品(十类)	其它纸及制品
65克离型原纸1200深黄	轻工、医药产品	纸及制品(十类)	纸板（原纸）
58克热敏原纸1564	轻工、医药产品	纸及制品(十类)	其它纸及制品
70克轻型胶版纸710	轻工、医药产品	纸及制品(十类)	机制纸（新闻纸）
67克离型原纸1300	轻工、医药产品	纸及制品(十类)	纸板（原纸）
65克离型原纸1200	轻工、医药产品	纸及制品(十类)	纸板（原纸）
65克离型原纸1098	轻工、医药产品	纸及制品(十类)	纸板（原纸）
65克轻型胶版纸710x1000	轻工、医药产品	纸及制品(十类)	机制纸（新闻纸）
65克离型原纸1210	轻工、医药产品	纸及制品(十类)	纸板（原纸）
70克离型原纸945	轻工、医药产品	纸及制品(十类)	纸板（原纸）
60克胶印书刊纸865	轻工、医药产品	文化体育用品	印刷品
80克胶印书刊纸710	轻工、医药产品	文化体育用品	印刷品
100克离型原纸32	轻工、医药产品	纸及制品(十类)	纸板（原纸）
100克离型原纸945	轻工、医药产品	纸及制品(十类)	纸板（原纸）
100克离型原纸1550	轻工、医药产品	纸及制品(十类)	纸板（原纸）
70克离型原纸1300	轻工、医药产品	纸及制品(十类)	纸板（原纸）
65克胶印书刊纸870	轻工、医药产品	文化体育用品	印刷品
80克胶印书刊纸787X1092	轻工、医药产品	文化体育用品	印刷品
60克轻型胶版纸780	轻工、医药产品	纸及制品(十类)	机制纸（新闻纸）
60克胶印书刊纸760	轻工、医药产品	文化体育用品	印刷品
58克胶印书刊纸880	轻工、医药产品	文化体育用品	印刷品
100克离型原纸1255	轻工、医药产品	纸及制品(十类)	纸板（原纸）
60克轻型胶版纸880	轻工、医药产品	纸及制品(十类)	机制纸（新闻纸）
60克轻型胶版纸815	轻工、医药产品	纸及制品(十类)	机制纸（新闻纸）
55克胶印书刊纸7871092	轻工、医药产品	文化体育用品	印刷品
55克胶印书刊纸787X1092	轻工、医药产品	文化体育用品	印刷品
80克离型原纸1250	轻工、医药产品	纸及制品(十类)	纸板（原纸）
60克轻型胶版纸770	轻工、医药产品	纸及制品(十类)	机制纸（新闻纸）
58克胶印书刊纸860	轻工、医药产品	文化体育用品	印刷品
55克胶印书刊纸780	轻工、医药产品	文化体育用品	印刷品
58克胶印书刊纸890X1240	轻工、医药产品	文化体育用品	印刷品
50克胶印书刊纸1960	轻工、医药产品	文化体育用品	印刷品
50克胶印书刊纸1715	轻工、医药产品	文化体育用品	印刷品
55克胶印书刊纸865	轻工、医药产品	文化体育用品	印刷品
55克胶印书刊纸765	轻工、医药产品	文化体育用品	印刷品
80克离型原纸1096	轻工、医药产品	纸及制品(十类)	纸板（原纸）
80克离型原纸1330	轻工、医药产品	纸及制品(十类)	纸板（原纸）
80克离型原纸970	轻工、医药产品	纸及制品(十类)	纸板（原纸）
80克离型原纸1580	轻工、医药产品	纸及制品(十类)	纸板（原纸）
80克离型原纸950	轻工、医药产品	纸及制品(十类)	纸板（原纸）
118克轻型胶版纸889	轻工、医药产品	纸及制品(十类)	机制纸（新闻纸）
118克轻型胶版纸787	轻工、医药产品	纸及制品(十类)	机制纸（新闻纸）
98克轻型胶版纸787	轻工、医药产品	纸及制品(十类)	机制纸（新闻纸）
118克轻型胶版纸720X1000	轻工、医药产品	纸及制品(十类)	机制纸（新闻纸）
70克轻型胶版纸880X1230	轻工、医药产品	纸及制品(十类)	机制纸（新闻纸）
70克轻型胶版纸710X1020	轻工、医药产品	纸及制品(十类)	机制纸（新闻纸）
70克离型原纸1098	轻工、医药产品	纸及制品(十类)	纸板（原纸）
65克离型原纸1038	轻工、医药产品	纸及制品(十类)	纸板（原纸）
60克离型原纸1098	轻工、医药产品	纸及制品(十类)	纸板（原纸）
60克胶印书刊纸845	轻工、医药产品	文化体育用品	印刷品
油黑	机械设备、电器	普通工业机械及设备	通用零部件
67克离型原纸1105	轻工、医药产品	纸及制品(十类)	纸板（原纸）
67克离型原纸1100	轻工、医药产品	纸及制品(十类)	纸板（原纸）
73克离型原纸1050	轻工、医药产品	纸及制品(十类)	纸板（原纸）
73克离型原纸1250	轻工、医药产品	纸及制品(十类)	纸板（原纸）
55克胶印书刊纸1965	轻工、医药产品	文化体育用品	印刷品
120克离型原纸945	轻工、医药产品	纸及制品(十类)	纸板（原纸）
80克离型原纸945	轻工、医药产品	纸及制品(十类)	纸板（原纸）
80克离型原纸1550	轻工、医药产品	纸及制品(十类)	纸板（原纸）
80克离型原纸1180	轻工、医药产品	纸及制品(十类)	纸板（原纸）
80克离型原纸1400	轻工、医药产品	纸及制品(十类)	纸板（原纸）
70克轻型胶版纸889X1194	轻工、医药产品	纸及制品(十类)	机制纸（新闻纸）
80克轻型胶版纸787X1320	轻工、医药产品	纸及制品(十类)	机制纸（新闻纸）
75克轻型胶版纸1030X720	轻工、医药产品	纸及制品(十类)	机制纸（新闻纸）
75克轻型胶版纸720X1030	轻工、医药产品	纸及制品(十类)	机制纸（新闻纸）
80克轻型胶版纸950X680	轻工、医药产品	纸及制品(十类)	机制纸（新闻纸）
80克轻型胶版纸680X950	轻工、医药产品	纸及制品(十类)	机制纸（新闻纸）
67克离型原纸1400	轻工、医药产品	纸及制品(十类)	纸板（原纸）
67克离型原纸1096	轻工、医药产品	纸及制品(十类)	纸板（原纸）
镀方管发嘉定	钢铁	钢 材、合金钢材	管材及附件
50克胶印书刊纸1720	轻工、医药产品	文化体育用品	印刷品
热管+方管发城阳	钢铁	钢 材、合金钢材	管材及附件
67克离型原纸945	轻工、医药产品	纸及制品(十类)	纸板（原纸）
方管发德清	钢铁	钢 材、合金钢材	管材及附件
方管发杭州	钢铁	钢 材、合金钢材	管材及附件
镀方管发杭州	钢铁	钢 材、合金钢材	管材及附件
方管发随州	钢铁	钢 材、合金钢材	管材及附件
110克轻型胶版纸787	轻工、医药产品	纸及制品(十类)	机制纸（新闻纸）
65克轻型胶版纸1000	轻工、医药产品	纸及制品(十类)	机制纸（新闻纸）
73克离型原纸1096	轻工、医药产品	纸及制品(十类)	纸板（原纸）
80克轻型胶版纸720x960	轻工、医药产品	纸及制品(十类)	机制纸（新闻纸）
60克胶印书刊纸870X1200	轻工、医药产品	文化体育用品	印刷品
60克胶印书刊纸830X1140	轻工、医药产品	文化体育用品	印刷品
58克热敏原纸1650	轻工、医药产品	纸及制品(十类)	其它纸及制品
70克离型原纸1195浅黄	轻工、医药产品	纸及制品(十类)	纸板（原纸）
70克离型原纸1095浅黄	轻工、医药产品	纸及制品(十类)	纸板（原纸）
静电复印纸	轻工、医药产品	文化体育用品	家具、坐具
方管发新乡	钢铁	钢 材、合金钢材	管材及附件
58克胶印书刊纸889X1240	轻工、医药产品	文化体育用品	印刷品
热镀白方	钢铁	钢 材、合金钢材	管材及附件
长沙欣昌热镀白方	机械设备、电器	专用机械、设备及制品	其它
长沙欣昌1车热镀3车白方	机械设备、电器	专用机械、设备及制品	其它
热方定尺米4发浙江永康	钢铁	钢 材、合金钢材	管材及附件
55克胶印书刊纸880X1194	轻工、医药产品	文化体育用品	印刷品
圆钢棒材汽运请看清要求	钢铁	钢 材、合金钢材	线材
热镀阜阳	钢铁	钢 材、合金钢材	管材及附件
方矩管+热镀方矩管	钢铁	钢 材、合金钢材	管材及附件
115克精致胶卷787	轻工、医药产品	工艺美术品	茶叶、咖啡、可可（豆、粉）
95克精致胶卷889	轻工、医药产品	工艺美术品	茶叶、咖啡、可可（豆、粉）
68克轻型胶版纸889X1230	轻工、医药产品	纸及制品(十类)	机制纸（新闻纸）
焊管镀锌纲塑	钢铁	钢 材、合金钢材	管材及附件
热镀方矩管+热镀管	钢铁	钢 材、合金钢材	管材及附件
南昌万溪热镀	轻工、医药产品	专用机械、设备及制品	树木
6克胶印书刊纸870	轻工、医药产品	文化体育用品	印刷品
60克轻型胶版纸886	轻工、医药产品	纸及制品(十类)	机制纸（新闻纸）
山西春雷热镀	轻工、医药产品	饮食品	竹
60克胶印书刊纸7871092	轻工、医药产品	文化体育用品	印刷品
60克胶印书刊纸890X1240	轻工、医药产品	文化体育用品	印刷品
70克胶印书刊纸787	轻工、医药产品	文化体育用品	印刷品
80克轻型胶版纸787	轻工、医药产品	纸及制品(十类)	机制纸（新闻纸）
70克离型原纸深黄1198	轻工、医药产品	纸及制品(十类)	纸板（原纸）
78克胶印书刊纸870	轻工、医药产品	文化体育用品	印刷品
70克离型原纸浅黄1096	轻工、医药产品	纸及制品(十类)	纸板（原纸）
白牛皮纸	轻工、医药产品	纸及制品(十类)	机制纸（新闻纸）
95克轻型胶版纸889	轻工、医药产品	纸及制品(十类)	机制纸（新闻纸）
95克轻型胶版纸787	轻工、医药产品	纸及制品(十类)	机制纸（新闻纸）
110克轻型胶版纸889	轻工、医药产品	纸及制品(十类)	机制纸（新闻纸）
60克轻型胶版纸890	轻工、医药产品	纸及制品(十类)	机制纸（新闻纸）
南昌热镀	钢铁	钢 材、合金钢材	管材及附件
50克胶印书刊纸390	轻工、医药产品	文化体育用品	印刷品
65克复合胶版纸886	轻工、医药产品	纸及制品(十类)	机制纸（新闻纸）
70克轻型胶版纸540	轻工、医药产品	纸及制品(十类)	机制纸（新闻纸）
60克胶印书刊纸710	轻工、医药产品	文化体育用品	印刷品
热镀7家	钢铁	钢铁制品	管材及附件
达盛热镀管	钢铁	钢 材、合金钢材	管材及附件
螺纹1	钢铁	钢 材、合金钢材	线材
螺纹2	钢铁	钢 材、合金钢材	线材
螺纹7	钢铁	钢 材、合金钢材	线材
螺纹8	钢铁	钢 材、合金钢材	线材
螺纹9	钢铁	钢 材、合金钢材	线材
螺纹11	钢铁	钢 材、合金钢材	线材
螺纹3	钢铁	钢 材、合金钢材	线材
螺纹4	钢铁	钢 材、合金钢材	线材
螺纹5	钢铁	钢 材、合金钢材	线材
螺纹6	钢铁	钢 材、合金钢材	线材
江西全通热镀	钢铁	钢 材、合金钢材	管材及附件
杭州华龙方加热方发杭州	钢铁	钢 材、合金钢材	管材及附件
55克胶印书刊纸850	轻工、医药产品	文化体育用品	印刷品
60克胶印书刊纸80	轻工、医药产品	文化体育用品	印刷品
方圆发松江	轻工、医药产品	饮食品	其它未列名饮食及调味食品
发松江圆	钢铁	钢 材、合金钢材	管材及附件
57克轻型胶版纸889	轻工、医药产品	纸及制品(十类)	机制纸（新闻纸）
57克轻型胶版纸720	轻工、医药产品	纸及制品(十类)	机制纸（新闻纸）
热镀加急	钢铁	钢 材、合金钢材	管材及附件
螺纹13	钢铁	钢 材、合金钢材	线材
热镀直属	钢铁	钢 材、合金钢材	管材及附件
螺纹014	钢铁	钢 材、合金钢材	线材
60克胶印书刊纸820	轻工、医药产品	文化体育用品	印刷品
螺纹15	钢铁	钢 材、合金钢材	线材
80克胶印书刊纸1103	轻工、医药产品	文化体育用品	印刷品
80克胶印书刊纸1243	轻工、医药产品	文化体育用品	印刷品
100克离型原纸1096	轻工、医药产品	纸及制品(十类)	纸板（原纸）
75克胶印书刊纸889	轻工、医药产品	文化体育用品	印刷品
75克胶印书刊纸851	轻工、医药产品	文化体育用品	印刷品
表箱	机械设备、电器	普通工业机械及设备	金属加工机械及设备
热镀31吨	钢铁	钢 材、合金钢材	管材及附件
焊管热镀发兰州	钢铁	钢 材、合金钢材	管材及附件
60克复合胶版纸886	轻工、医药产品	纸及制品(十类)	机制纸（新闻纸）
热方定尺7米4发永康	钢铁	钢 材、合金钢材	管材及附件
螺纹17	钢铁	钢 材、合金钢材	线材
68克轻型胶版纸787x1092	轻工、医药产品	纸及制品(十类)	机制纸（新闻纸）
68克轻型胶版纸889x1194	轻工、医药产品	纸及制品(十类)	机制纸（新闻纸）
67克轻型胶版纸787	轻工、医药产品	纸及制品(十类)	机制纸（新闻纸）
67克轻型胶版纸720	轻工、医药产品	纸及制品(十类)	机制纸（新闻纸）
67克轻型胶版纸880	轻工、医药产品	纸及制品(十类)	机制纸（新闻纸）
67克轻型胶版纸889	轻工、医药产品	纸及制品(十类)	机制纸（新闻纸）
57克轻型胶版纸787	轻工、医药产品	纸及制品(十类)	机制纸（新闻纸）
68克轻型胶版纸787	轻工、医药产品	纸及制品(十类)	机制纸（新闻纸）
螺纹01	钢铁	钢 材、合金钢材	线材
螺纹001	钢铁	钢 材、合金钢材	线材
热镀蚌埠	钢铁	钢 材、合金钢材	管材及附件
64克热敏原纸1630	轻工、医药产品	纸及制品(十类)	其它纸及制品
65克离型原纸深黄1038	轻工、医药产品	纸及制品(十类)	纸板（原纸）
70克离型原纸深黄1098	轻工、医药产品	纸及制品(十类)	纸板（原纸）
60克离型原纸深黄1098	轻工、医药产品	纸及制品(十类)	纸板（原纸）
70克离型原纸深典1098	轻工、医药产品	纸及制品(十类)	纸板（原纸）
77克轻型胶版纸787	轻工、医药产品	纸及制品(十类)	机制纸（新闻纸）
60克轻型胶版纸787X1092	轻工、医药产品	纸及制品(十类)	机制纸（新闻纸）
螺纹18	钢铁	钢 材、合金钢材	线材
65克胶印书刊纸889	轻工、医药产品	文化体育用品	印刷品
65克胶印书刊纸787	轻工、医药产品	文化体育用品	印刷品
80克轻型胶版纸889x1194	轻工、医药产品	纸及制品(十类)	机制纸（新闻纸）
60克轻型胶版纸1500	轻工、医药产品	纸及制品(十类)	机制纸（新闻纸）
80克轻型胶版纸880x1230	轻工、医药产品	纸及制品(十类)	机制纸（新闻纸）
80克轻型胶版纸1500	轻工、医药产品	纸及制品(十类)	机制纸（新闻纸）
热镀管天津港	钢铁	钢 材、合金钢材	管材及附件
65克离型原纸1096深黄	轻工、医药产品	纸及制品(十类)	纸板（原纸）
65克离型原纸1196深黄	轻工、医药产品	纸及制品(十类)	纸板（原纸）
60克胶印书刊纸787X1194	轻工、医药产品	文化体育用品	印刷品
热镀明天必须到货	钢铁	钢 材、合金钢材	管材及附件
80克象牙白道森纸	轻工、医药产品	纸及制品(十类)	机制纸（新闻纸）
热镀宿州直属车	钢铁	钢 材、合金钢材	管材及附件
60克轻型胶版纸890X1260	轻工、医药产品	纸及制品(十类)	机制纸（新闻纸）
65克轻型胶版纸1230x880	轻工、医药产品	纸及制品(十类)	机制纸（新闻纸）
70克离型原纸1200	轻工、医药产品	纸及制品(十类)	纸板（原纸）
苯板 胶粉 网格布	轻工、医药产品	日用工业品	纸板（原纸）
家电 电脑 办公设备	机械设备、电器	电力设备、电器机械及器材	家用电器
68克离型原纸1100	轻工、医药产品	纸及制品(十类)	纸板（原纸）
80克离型原纸1100	轻工、医药产品	纸及制品(十类)	纸板（原纸）
55克胶印书刊纸820	轻工、医药产品	文化体育用品	印刷品
螺纹19	钢铁	钢 材、合金钢材	线材
67克离型原纸950	轻工、医药产品	纸及制品(十类)	纸板（原纸）
热镀方矩管+方矩管	钢铁	钢 材、合金钢材	管材及附件
螺纹21	钢铁	钢 材、合金钢材	线材
螺纹22	钢铁	钢 材、合金钢材	线材
螺纹02	钢铁	钢 材、合金钢材	线材
55克胶印书刊纸940	轻工、医药产品	文化体育用品	印刷品
70克离型原纸深黄1200	轻工、医药产品	纸及制品(十类)	纸板（原纸）
70克离型原纸深黄1038	轻工、医药产品	纸及制品(十类)	纸板（原纸）
70克离型原纸1200深黄	轻工、医药产品	纸及制品(十类)	纸板（原纸）
热轧带钢	钢铁	钢铁制品	钢铁件及其它五金制品
73克离型原纸1200	轻工、医药产品	纸及制品(十类)	纸板（原纸）
70克离型原纸1096	轻工、医药产品	纸及制品(十类)	纸板（原纸）
螺纹03	钢铁	钢 材、合金钢材	线材
螺纹04	钢铁	钢 材、合金钢材	线材
螺纹05	钢铁	钢 材、合金钢材	线材
螺纹06	钢铁	钢 材、合金钢材	线材
螺纹07	钢铁	钢 材、合金钢材	线材
螺纹08	钢铁	钢 材、合金钢材	线材
螺纹09	钢铁	钢 材、合金钢材	线材
螺纹23	钢铁	钢 材、合金钢材	线材
螺纹24	钢铁	钢 材、合金钢材	线材
螺纹25	钢铁	钢 材、合金钢材	线材
螺纹26	钢铁	钢 材、合金钢材	线材
螺纹27	钢铁	钢 材、合金钢材	线材
螺纹28	钢铁	钢 材、合金钢材	线材
螺纹29	钢铁	钢 材、合金钢材	线材
螺纹30	钢铁	钢 材、合金钢材	线材
螺纹31	钢铁	钢 材、合金钢材	线材
螺纹32	钢铁	钢 材、合金钢材	线材
螺纹33	钢铁	钢 材、合金钢材	线材
螺纹34	钢铁	钢 材、合金钢材	线材
65克胶印书刊纸880	轻工、医药产品	文化体育用品	印刷品
三级螺纹钢28	钢铁	钢 材、合金钢材	线材
方加热方发德清	钢铁	钢 材、合金钢材	管材及附件
电脑 示波器 万用表	机械设备、电器	电子、电讯设备及器材	轻工业机械及零件
70克离型原纸浅黄1195	轻工、医药产品	纸及制品(十类)	纸板（原纸）
70克离型原纸浅黄1095	轻工、医药产品	纸及制品(十类)	纸板（原纸）
64克三防热敏原纸1630	钢铁	钢 材、合金钢材	管材及附件
58克三防热敏原纸1564	钢铁	钢 材、合金钢材	管材及附件
58克热敏原纸1102	轻工、医药产品	纸及制品(十类)	其它纸及制品
58克三防热敏原纸1102	钢铁	钢 材、合金钢材	管材及附件
45克三防热敏原纸1225	钢铁	钢 材、合金钢材	管材及附件
70克轻型胶版纸530	轻工、医药产品	纸及制品(十类)	机制纸（新闻纸）
70克轻型胶版纸575	轻工、医药产品	纸及制品(十类)	机制纸（新闻纸）
热镀34吨	钢铁	钢 材、合金钢材	管材及附件
55克轻型胶版纸880X1240	轻工、医药产品	纸及制品(十类)	机制纸（新闻纸）
焊管镀锌	钢铁	钢 材、合金钢材	管材及附件
55克胶印书刊纸394X2	轻工、医药产品	文化体育用品	印刷品
55克胶印书刊纸3942X2	轻工、医药产品	文化体育用品	印刷品
70克轻型胶版纸765	轻工、医药产品	纸及制品(十类)	机制纸（新闻纸）
80克轻型胶版纸787X1230	轻工、医药产品	纸及制品(十类)	机制纸（新闻纸）
溶剂油等	化工原料及制品	其它未列名化工原料及制品	其它
溶剂油	化工原料及制品	其它未列名化工原料及制品	其它
70克轻型胶版纸720X960	轻工、医药产品	纸及制品(十类)	机制纸（新闻纸）
78克轻型胶版纸710X1000	轻工、医药产品	纸及制品(十类)	机制纸（新闻纸）
78克轻型胶版纸720X960	轻工、医药产品	纸及制品(十类)	机制纸（新闻纸）
41克无炭复写纸1035	轻工、医药产品	纸及制品(十类)	机制纸（新闻纸）
60克胶印书刊纸880X1270	轻工、医药产品	文化体育用品	印刷品
55克胶印书刊纸1600	轻工、医药产品	文化体育用品	印刷品
65克轻型胶版纸720	轻工、医药产品	纸及制品(十类)	机制纸（新闻纸）
55克胶印书刊纸845	轻工、医药产品	文化体育用品	印刷品
如意雅白道林纸	轻工、医药产品	纸及制品(十类)	其它纸及制品
70克轻型胶版纸690X980	轻工、医药产品	纸及制品(十类)	机制纸（新闻纸）
68克轻型胶版纸965	轻工、医药产品	纸及制品(十类)	机制纸（新闻纸）
螺纹37	钢铁	钢 材、合金钢材	线材
7家济南1车螺旋热镀两厂两磅	钢铁	其它未列名矿建材料	其它
螺纹36	钢铁	钢 材、合金钢材	线材
焊管套管发成都金堂县怀口电厂	钢铁	钢 材、合金钢材	管材及附件
螺纹38	钢铁	钢 材、合金钢材	线材
棒材汽车运输请看清要求	钢铁	钢 材、合金钢材	管材及附件
80克轻型胶版纸889X1320	轻工、医药产品	纸及制品(十类)	机制纸（新闻纸）
70克轻型胶版纸590	轻工、医药产品	纸及制品(十类)	机制纸（新闻纸）
78g如意米黄双胶纸	轻工、医药产品	纸及制品(十类)	其它
100g华章轻型纸	轻工、医药产品	日用工业品	家具、坐具
68g华章轻型纸	轻工、医药产品	日用工业品	家具、坐具
58g如意双胶纸	轻工、医药产品	纸及制品(十类)	纸板（原纸）
发景德镇31吨热方	钢铁	钢 材、合金钢材	管材及附件
55克胶印书刊纸781	轻工、医药产品	文化体育用品	印刷品
68克轻型胶版纸720	轻工、医药产品	纸及制品(十类)	机制纸（新闻纸）
70克轻型胶版纸1000X700	轻工、医药产品	纸及制品(十类)	机制纸（新闻纸）
68克轻型胶版纸1000X700	轻工、医药产品	纸及制品(十类)	机制纸（新闻纸）
热镀加螺旋3磅	钢铁	钢 材、合金钢材	钢铁件及其它五金制品
热镀白方两厂两磅	钢铁	钢 材、合金钢材	管材及附件
热方加热镀南北厂31T	钢铁	钢 材、合金钢材	管材及附件
58克胶印书刊纸770	轻工、医药产品	文化体育用品	印刷品
螺纹X	钢铁	钢 材、合金钢材	线材
热镀螺旋	钢铁	钢 材、合金钢材	管材及附件
螺纹35	钢铁	钢 材、合金钢材	线材
螺纹39	钢铁	钢 材、合金钢材	线材
螺纹40	钢铁	钢 材、合金钢材	线材
螺纹41	钢铁	钢 材、合金钢材	线材
螺纹42	钢铁	钢 材、合金钢材	线材
螺纹66	钢铁	钢 材、合金钢材	线材
螺纹67	钢铁	钢 材、合金钢材	线材
螺纹68	钢铁	钢 材、合金钢材	线材
螺纹69	钢铁	钢 材、合金钢材	线材
热镀加焊管发吴江	钢铁	钢 材、合金钢材	管材及附件
螺纹92	钢铁	钢 材、合金钢材	线材
螺纹93	钢铁	钢 材、合金钢材	线材
螺纹94	钢铁	钢 材、合金钢材	线材
螺纹99	钢铁	钢 材、合金钢材	线材
螺纹100	钢铁	钢 材、合金钢材	线材
螺纹101	钢铁	钢 材、合金钢材	线材
螺纹102	钢铁	钢 材、合金钢材	线材
螺纹103	钢铁	钢 材、合金钢材	线材
螺纹104	钢铁	钢 材、合金钢材	线材
螺纹105	钢铁	钢 材、合金钢材	线材
螺纹106	钢铁	钢 材、合金钢材	线材
螺纹111	钢铁	钢 材、合金钢材	线材
螺纹112	钢铁	钢 材、合金钢材	线材
螺纹113	钢铁	钢 材、合金钢材	线材
螺旋加热镀33T	钢铁	钢 材、合金钢材	管材及附件
道林纸	轻工、医药产品	其它	其它
PC161223000034微波炉	机械设备、电器	电力设备、电器机械及器材	钢铁容器
75克典雅纯质纸1000	轻工、医药产品	纸及制品(十类)	其它纸及制品
75克典雅纯质纸710	轻工、医药产品	纸及制品(十类)	其它纸及制品
65克典雅纯质纸710	轻工、医药产品	纸及制品(十类)	其它纸及制品
65克典雅纯质纸1000	轻工、医药产品	纸及制品(十类)	其它纸及制品
热镀31T	钢铁	钢 材、合金钢材	管材及附件
发成都热方7家	钢铁	钢 材、合金钢材	管材及附件
热镀临沂	钢铁	钢 材、合金钢材	管材及附件
60克轻型胶版纸710X1000	轻工、医药产品	纸及制品(十类)	机制纸（新闻纸）
萍乡热镀32吨热镀	钢铁	钢 材、合金钢材	管材及附件
热镀12T	钢铁	钢 材、合金钢材	管材及附件
70克轻型胶版纸710X1000	轻工、医药产品	纸及制品(十类)	机制纸（新闻纸）
80克轻型胶版纸889X1230	轻工、医药产品	纸及制品(十类)	机制纸（新闻纸）
热镀32T莘县	钢铁	钢 材、合金钢材	管材及附件
热圆发南昌	钢铁	钢 材、合金钢材	管材及附件
热圆发扬州	钢铁	钢 材、合金钢材	线材
PC161224000039微波炉	机械设备、电器	电力设备、电器机械及器材	钢铁容器
PC161214000035微波炉	机械设备、电器	电力设备、电器机械及器材	钢铁容器
70克轻型胶版纸980X690	轻工、医药产品	纸及制品(十类)	机制纸（新闻纸）
热圆发十堰	钢铁	钢 材、合金钢材	线材
PC161214000041微波炉	机械设备、电器	电力设备、电器机械及器材	钢铁容器
PC161206000087洗衣机	机械设备、电器	电力设备、电器机械及器材	家用电器
焊管加热镀发西安	钢铁	钢 材、合金钢材	管材及附件
PC161130000044卷纸	其它货类	纸及制品(十类)	其它
PC161211000004卷纸	其它货类	纸及制品(十类)	其它
PC161220000052卷纸	其它货类	纸及制品(十类)	其它
PC161222000101卷纸	其它货类	纸及制品(十类)	其它
焊镀发宝鸡	钢铁	钢 材、合金钢材	钢铁件及其它五金制品
65克轻型胶版纸780	轻工、医药产品	纸及制品(十类)	机制纸（新闻纸）
黑方加热方发武汉	钢铁	钢 材、合金钢材	管材及附件
70g如意米黄双胶纸	轻工、医药产品	纸及制品(十类)	其它
黑方+热方发南昌31吨	钢铁	钢 材、合金钢材	管材及附件
80g皓月双胶纸	轻工、医药产品	纸及制品(十类)	其它
南钢三级螺纹钢16	钢铁	钢 材、合金钢材	线材
55克胶印书刊纸880X1240	轻工、医药产品	文化体育用品	印刷品
南钢14螺纹14抗	钢铁	钢 材、合金钢材	线材
55看胶印书刊纸820	轻工、医药产品	纸及制品(十类)	机制纸（新闻纸）
75克轻型胶版纸720	轻工、医药产品	纸及制品(十类)	机制纸（新闻纸）
75克轻型胶版纸965	轻工、医药产品	纸及制品(十类)	机制纸（新闻纸）
65克离型原纸深典1210	轻工、医药产品	纸及制品(十类)	纸板（原纸）
65克离型原纸深黄1098	轻工、医药产品	纸及制品(十类)	纸板（原纸）
黑方加热方发石家庄	钢铁	钢 材、合金钢材	管材及附件
80克轻型胶版纸889	轻工、医药产品	纸及制品(十类)	机制纸（新闻纸）
78克轻型胶版纸787	轻工、医药产品	纸及制品(十类)	机制纸（新闻纸）
热圆发松江	轻工、医药产品	工艺美术品	其它未列名饮食及调味食品
100克离型原纸950	轻工、医药产品	纸及制品(十类)	纸板（原纸）
80克离型原纸1300	轻工、医药产品	纸及制品(十类)	纸板（原纸）
100克离型原纸1400	轻工、医药产品	纸及制品(十类)	纸板（原纸）
100克离型原纸1300	轻工、医药产品	纸及制品(十类)	纸板（原纸）
黑方+热方发南昌	钢铁	钢 材、合金钢材	管材及附件
73克离型原纸1120	轻工、医药产品	纸及制品(十类)	纸板（原纸）
73克离型原纸1110	轻工、医药产品	纸及制品(十类)	纸板（原纸）
120克离型原纸1300	轻工、医药产品	纸及制品(十类)	纸板（原纸）
100克离型原纸1100	轻工、医药产品	纸及制品(十类)	纸板（原纸）
100克离型原纸1635	轻工、医药产品	纸及制品(十类)	纸板（原纸）
80克离型原纸1610	轻工、医药产品	纸及制品(十类)	纸板（原纸）
70克离型原纸990	轻工、医药产品	纸及制品(十类)	纸板（原纸）
80克离型原纸900	轻工、医药产品	纸及制品(十类)	纸板（原纸）
120克离型原纸2060	轻工、医药产品	纸及制品(十类)	纸板（原纸）
热镀7家31点5吨	钢铁	钢铁制品	管材及附件
热镀31点5吨	钢铁	钢 材、合金钢材	管材及附件
60克离型原纸1300	轻工、医药产品	纸及制品(十类)	纸板（原纸）
60克离型原纸950	轻工、医药产品	纸及制品(十类)	纸板（原纸）
60克离型原纸1100	轻工、医药产品	纸及制品(十类)	纸板（原纸）
南昌昌北经济开发区龙潭路+仓库31吨热方两地卸车	轻工、医药产品	其它	其它
热镀7家31T	钢铁	钢铁制品	管材及附件
60克胶印书刊纸440	轻工、医药产品	文化体育用品	印刷品
PC161228000111微波炉	机械设备、电器	电力设备、电器机械及器材	钢铁容器
方加热方发杭州	钢铁	钢 材、合金钢材	管材及附件
70克胶印书刊纸880	轻工、医药产品	文化体育用品	印刷品
67克离型原纸1198	轻工、医药产品	纸及制品(十类)	纸板（原纸）
67克离型原纸1028	轻工、医药产品	纸及制品(十类)	纸板（原纸）
67克离型原纸1200	轻工、医药产品	纸及制品(十类)	纸板（原纸）
焊管加热镀发太原	钢铁	钢 材、合金钢材	管材及附件
热镀加白方	钢铁	钢 材、合金钢材	管材及附件
68克离型原纸1020	轻工、医药产品	纸及制品(十类)	纸板（原纸）
70克离型原纸1280	轻工、医药产品	纸及制品(十类)	纸板（原纸）
75克离型原纸1285	轻工、医药产品	纸及制品(十类)	纸板（原纸）
热镀江西大鹏	钢铁	钢 材、合金钢材	管材及附件
商河热镀	钢铁	钢 材、合金钢材	管材及附件
热镀加焊管7家发南阳	钢铁	钢 材、合金钢材	管材及附件
立式铣床	轻工、医药产品	饮食品	金属加工机械及设备
热镀加焊管发南阳	钢铁	钢 材、合金钢材	管材及附件
热镀阜阳颖上	钢铁	钢 材、合金钢材	管材及附件
阿拉巴马浆	轻工、医药产品	纸及制品(十类)	纸浆
象牌小叶浆	轻工、医药产品	纸及制品(十类)	纸浆
胶水	轻工、医药产品	日用工业品	其它日用品
焊管加热镀发新乡	钢铁	钢 材、合金钢材	管材及附件
热圆发重庆	钢铁	钢 材、合金钢材	线材
纸张	轻工、医药产品	纸及制品(十类)	其它纸及制品
南昌31吨热镀	金属矿石	钢 材、合金钢材	管材及附件
热方1车发南昌	钢铁	钢 材、合金钢材	管材及附件
65克轻型胶版纸889	轻工、医药产品	纸及制品(十类)	机制纸（新闻纸）
热圆发长沙	钢铁	钢 材、合金钢材	线材
60克胶印书刊纸394X2	轻工、医药产品	文化体育用品	印刷品
55克胶印书刊纸889X1194	轻工、医药产品	文化体育用品	印刷品
80克轻型胶版纸787X1092	轻工、医药产品	纸及制品(十类)	机制纸（新闻纸）
70克轻型胶版纸787X1092	轻工、医药产品	纸及制品(十类)	机制纸（新闻纸）
热镀31	钢铁	钢 材、合金钢材	管材及附件
70克轻型胶版纸889	轻工、医药产品	纸及制品(十类)	机制纸（新闻纸）
55克胶印书刊纸725	轻工、医药产品	文化体育用品	印刷品
50克胶印书刊纸1475	轻工、医药产品	文化体育用品	印刷品
西宁热镀	钢铁	钢 材、合金钢材	管材及附件
书刊	轻工、医药产品	文化体育用品	印刷品
热方+黑方发南昌	钢铁	钢 材、合金钢材	管材及附件
数控机床	机械设备、电器	专用机械、设备及制品	金属加工机械及设备
文件柜	轻工、医药产品	日用工业品	其它
68克离型原纸1096	轻工、医药产品	纸及制品(十类)	纸板（原纸）
玻璃纤维	轻工、医药产品	针织、纺织、皮毛及制品	纱、线、丝、纤维（非复合材料）
55克胶印书刊纸890	轻工、医药产品	文化体育用品	印刷品
工业丝	钢铁	钢铁制品	铁或非合金钢板轧材、卷、角、型材
80克轻型胶版纸889X635	轻工、医药产品	纸及制品(十类)	机制纸（新闻纸）
52克胶印书刊纸	轻工、医药产品	文化体育用品	印刷品
52克胶印书刊纸787	轻工、医药产品	文化体育用品	印刷品
立式升降台铣床	轻工、医药产品	钢铁制品	通用设备
60克880卷筒傅汇胶版纸	轻工、医药产品	工艺美术品	雕塑、刻、漆工艺品
兴钢备货螺纹	机械设备、电器	普通工业机械及设备	通用零部件
55克轻型胶版纸700	轻工、医药产品	纸及制品(十类)	机制纸（新闻纸）
泰安热镀	钢铁	钢铁制品	管材及附件
扬州热镀	钢铁	钢 材、合金钢材	管材及附件
60克轻型胶版纸781	轻工、医药产品	纸及制品(十类)	机制纸（新闻纸）
120克离型原纸1096	轻工、医药产品	纸及制品(十类)	纸板（原纸）
长沙热镀39T	钢铁	钢 材、合金钢材	管材及附件
60克期刊杂志纸880	轻工、医药产品	饮食品	其它
70克轻型胶版纸960X705	轻工、医药产品	纸及制品(十类)	机制纸（新闻纸）
70克轻型胶版纸705X960	轻工、医药产品	纸及制品(十类)	机制纸（新闻纸）
70克离型原纸浅黄1206	轻工、医药产品	纸及制品(十类)	纸板（原纸）
67克离型原纸深黄1198	轻工、医药产品	纸及制品(十类)	纸板（原纸）
中铝螺纹	钢铁	钢 材、合金钢材	线材
55克胶印书刊纸550x2	轻工、医药产品	文化体育用品	印刷品
热镀38T	钢铁	钢 材、合金钢材	管材及附件
60克胶印书刊纸960x640	轻工、医药产品	文化体育用品	印刷品
70克庆铜质版纸优光870x1194	轻工、医药产品	纸及制品(十类)	机制纸（新闻纸）
发成都热方18号必须卸货	钢铁	钢 材、合金钢材	管材及附件
65克轻型胶版纸770	轻工、医药产品	纸及制品(十类)	机制纸（新闻纸）
55克轻型胶版纸770	轻工、医药产品	纸及制品(十类)	机制纸（新闻纸）
70克离型原纸1026	轻工、医药产品	纸及制品(十类)	纸板（原纸）
70克离型原纸1195	轻工、医药产品	纸及制品(十类)	纸板（原纸）
甜面酱	粮食	饮食品	糕点、面食、谷物食品
豆瓣+促销	粮食	杂粮	其它运输辅件及器材
热镀32T	钢铁	钢 材、合金钢材	管材及附件
机械	轻工、医药产品	饮食品	饮料、果菜汁
白方加热镀16T	钢铁	钢 材、合金钢材	管材及附件
60克880卷筒博汇胶版纸	轻工、医药产品	钢 材、合金钢材	铁或非合金钢板轧材、卷、角、型材
55克胶印书刊纸780X1092	轻工、医药产品	文化体育用品	印刷品
常州向远三车热镀	钢铁	钢 材、合金钢材	管材及附件
城阳1车黑方热镀两厂两磅	钢铁	钢 材、合金钢材	管材及附件
80克白道林纸710	轻工、医药产品	纸及制品(十类)	机制纸（新闻纸）
切割油	农、林、牧、渔业产品	经济作物及制品	动植物食用油料、脂肪及制品
油井配件	机械设备、电器	普通工业机械及设备	通用设备
70克离型原纸深黄1058	轻工、医药产品	纸及制品(十类)	纸板（原纸）
70克离型原纸浅黄1026	轻工、医药产品	纸及制品(十类)	纸板（原纸）
60克胶印书刊纸710X1000	轻工、医药产品	文化体育用品	印刷品
73克离型原纸深黄1098	轻工、医药产品	纸及制品(十类)	纸板（原纸）
仪器	机械设备、电器	仪器仪表、计量器具、工具	仪器仪表
75克轻型胶版纸787	轻工、医药产品	纸及制品(十类)	机制纸（新闻纸）
纲塑配热镀	化工原料及制品	工艺美术品	雕塑、刻、漆工艺品
镀锌压型钢板	钢铁	钢 材、合金钢材	管材及附件
70克离型原纸1038	轻工、医药产品	纸及制品(十类)	纸板（原纸）
70克离型原纸1058	轻工、医药产品	纸及制品(十类)	纸板（原纸）
70克离型原纸1026浅黄	轻工、医药产品	纸及制品(十类)	纸板（原纸）
哈尔滨冰爽9度330ML4X6纸箱听装塑膜	机械设备、电器	电力设备、电器机械及器材	家用电器
哈尔滨麦道10度580ML1X12纸箱回瓶装	钢铁	其它未列名矿建材料	道路机动车辆
哈尔滨清爽8度500ML1X12纸箱回瓶装无格挡	机械设备、电器	专用机械、设备及制品	家具、坐具
70克轻型胶版纸700	轻工、医药产品	纸及制品(十类)	机制纸（新闻纸）
哈尔滨冰爽9度330ML1X24纸箱回瓶装	机械设备、电器	电力设备、电器机械及器材	家用电器
维雪喜年华9度580ML1X12纸箱回瓶装哈啤联合品牌	轻工、医药产品	饮食品	家具、坐具
哈尔滨冰爽9度500ML1X12纸箱听装	机械设备、电器	电力设备、电器机械及器材	家用电器
热镀6608	钢铁	钢 材、合金钢材	管材及附件
商品车11板	机械设备、电器	专用机械、设备及制品	道路机动车辆
商品车10板	机械设备、电器	专用机械、设备及制品	道路机动车辆
钢管8158	钢铁	钢 材、合金钢材	管材及附件
78克轻型胶版纸889X1194	轻工、医药产品	纸及制品(十类)	机制纸（新闻纸）
78克轻型胶版纸787X1092	轻工、医药产品	纸及制品(十类)	机制纸（新闻纸）
78克轻型胶版纸710X980	轻工、医药产品	纸及制品(十类)	机制纸（新闻纸）
热镀+螺旋	钢铁	钢 材、合金钢材	管材及附件
哈尔滨冰爽9度500ML1X12纸箱听装16吨	机械设备、电器	电力设备、电器机械及器材	家用电器
热方加方发常州	钢铁	钢 材、合金钢材	管材及附件
玻璃纤维短纤	轻工、医药产品	针织、纺织、皮毛及制品	纱、线、丝、纤维（非复合材料）
热镀加焊管发苏州工业园	钢铁	钢 材、合金钢材	管材及附件
焊家热镀加纲塑	钢铁	钢 材、合金钢材	管材及附件
发藁城热方	钢铁	钢 材、合金钢材	管材及附件
热镀徐州	钢铁	钢 材、合金钢材	管材及附件
70克轻型胶版纸650	轻工、医药产品	纸及制品(十类)	机制纸（新闻纸）
58克胶印书刊纸780	轻工、医药产品	文化体育用品	印刷品
车方热方发常州	钢铁	钢 材、合金钢材	管材及附件
床上用品	轻工、医药产品	日用工业品	家具、坐具
s双胶纸	轻工、医药产品	纸及制品(十类)	其它纸及制品
60克胶印书刊纸880x1230	轻工、医药产品	文化体育用品	印刷品
浙江华拓热方发德清	钢铁	钢 材、合金钢材	管材及附件
发成都热方	钢铁	钢 材、合金钢材	管材及附件
临沂热镀	钢铁	钢 材、合金钢材	管材及附件
52克铜版本原纸896	轻工、医药产品	纸及制品(十类)	纸板（原纸）
圆发德清	钢铁	钢 材、合金钢材	线材
方热方发常州	钢铁	钢 材、合金钢材	管材及附件
焊家热镀	钢铁	钢 材、合金钢材	管材及附件
焊管加热镀发新乡33吨	钢铁	钢 材、合金钢材	管材及附件
方热方发德清	钢铁	钢 材、合金钢材	管材及附件
方热方发杭州	钢铁	钢 材、合金钢材	管材及附件
发松滋一车热方30吨	化工原料及制品	工艺美术品	其它未列名饮食及调味食品
济南热镀	钢铁	钢 材、合金钢材	管材及附件
湖北友发热方发武汉	轻工、医药产品	日用工业品	其它未列名饮食及调味食品
黑方加热镀直属	钢铁	钢 材、合金钢材	管材及附件
热镀加吉利40T	钢铁	钢 材、合金钢材	管材及附件
55克轻型胶版纸880	轻工、医药产品	纸及制品(十类)	机制纸（新闻纸）
70克轻型胶版纸940	轻工、医药产品	纸及制品(十类)	机制纸（新闻纸）
湖北友发发武汉热方	轻工、医药产品	日用工业品	其它未列名饮食及调味食品
60克轻型胶版纸889	轻工、医药产品	纸及制品(十类)	机制纸（新闻纸）
发热圆	钢铁	钢 材、合金钢材	管材及附件
花岗岩垫石	轻工、医药产品	专用机械、设备及制品	其它日用品
3号电镀锌角钢	钢铁	钢 材、合金钢材	管材及附件
4号电镀锌角钢	钢铁	钢 材、合金钢材	管材及附件
热镀加纲塑13T	钢铁	钢 材、合金钢材	管材及附件
热镀33T	钢铁	钢 材、合金钢材	管材及附件
55克轻型胶版纸780	轻工、医药产品	纸及制品(十类)	机制纸（新闻纸）
哈尔滨冰纯91度600ML1X12纸箱回瓶装	机械设备、电器	电力设备、电器机械及器材	家用电器
哈尔滨冰爽9度330ML4X6纸箱听装机械黄包箱	机械设备、电器	电力设备、电器机械及器材	家用电器
5#镀锌角钢	钢铁	钢 材、合金钢材	型材
热镀40T	钢铁	钢 材、合金钢材	管材及附件
苏州朝东热镀不叉	钢铁	钢 材、合金钢材	管材及附件
电厂焊管套管	钢铁	钢 材、合金钢材	管材及附件
65克离型原纸1210深黄	轻工、医药产品	纸及制品(十类)	纸板（原纸）
65克离型原纸1098深黄	轻工、医药产品	纸及制品(十类)	纸板（原纸）
发济南章丘枣园镇热方	钢铁	钢 材、合金钢材	管材及附件
73克离型原纸1285	轻工、医药产品	纸及制品(十类)	纸板（原纸）
80克离型原纸820	轻工、医药产品	纸及制品(十类)	纸板（原纸）
80克离型原纸1050	轻工、医药产品	纸及制品(十类)	纸板（原纸）
80克离型原纸1305	轻工、医药产品	纸及制品(十类)	纸板（原纸）
60克轻型胶版纸640	轻工、医药产品	纸及制品(十类)	机制纸（新闻纸）
60克轻型胶版纸970	轻工、医药产品	纸及制品(十类)	机制纸（新闻纸）
80克离型原纸1555	轻工、医药产品	纸及制品(十类)	纸板（原纸）
60克轻型胶版纸730	轻工、医药产品	纸及制品(十类)	机制纸（新闻纸）
60克轻型胶版纸1010	轻工、医药产品	纸及制品(十类)	机制纸（新闻纸）
100克离型原纸1105	轻工、医药产品	纸及制品(十类)	纸板（原纸）
100克离型原纸1305	轻工、医药产品	纸及制品(十类)	纸板（原纸）
100克离型原纸1250	轻工、医药产品	纸及制品(十类)	纸板（原纸）
100克离型原纸1405	轻工、医药产品	纸及制品(十类)	纸板（原纸）
120克离型原纸1550	轻工、医药产品	纸及制品(十类)	纸板（原纸）
58克轻型胶版纸889	轻工、医药产品	纸及制品(十类)	机制纸（新闻纸）
58克轻型胶版纸880	轻工、医药产品	纸及制品(十类)	机制纸（新闻纸）
65克轻型胶版纸730	轻工、医药产品	纸及制品(十类)	机制纸（新闻纸）
65克轻型胶版纸980	轻工、医药产品	纸及制品(十类)	机制纸（新闻纸）
百威97度330ML1X24纸箱听装	轻工、医药产品	纸及制品(十类)	其它
热镀加焊管33T发长治	钢铁	钢 材、合金钢材	管材及附件
73克离型原纸1205	轻工、医药产品	纸及制品(十类)	纸板（原纸）
73克离型原纸800	轻工、医药产品	纸及制品(十类)	纸板（原纸）
白方热镀	钢铁	钢 材、合金钢材	管材及附件
78克高白胶板印刷纸787	轻工、医药产品	纸及制品(十类)	机制纸（新闻纸）
78克高白胶板印刷纸889	轻工、医药产品	纸及制品(十类)	机制纸（新闻纸）
98克高白胶板印刷纸787	轻工、医药产品	纸及制品(十类)	机制纸（新闻纸）
98克高白胶板印刷纸889	轻工、医药产品	纸及制品(十类)	机制纸（新闻纸）
55克轻型胶版纸870	轻工、医药产品	纸及制品(十类)	机制纸（新闻纸）
黑方加热镀13T	钢铁	钢 材、合金钢材	管材及附件
75克高白胶板印刷纸787	轻工、医药产品	纸及制品(十类)	机制纸（新闻纸）
75克高白胶板印刷纸880	轻工、医药产品	纸及制品(十类)	机制纸（新闻纸）
补冀DJ9278热镀13日	钢铁	钢 材、合金钢材	管材及附件
南昌32吨热镀	金属矿石	钢 材、合金钢材	管材及附件
70克全轻型胶版纸530	轻工、医药产品	纸及制品(十类)	纸板（原纸）
消防管件	钢铁	钢 材、合金钢材	管材及附件
合肥宝光当涂县一车热镀芜湖两磅	轻工、医药产品	工艺美术品	雕塑、刻、漆工艺品
热镀16T	钢铁	钢 材、合金钢材	管材及附件
75克高白胶板印刷纸889	轻工、医药产品	纸及制品(十类)	机制纸（新闻纸）
60克胶印书刊纸635X889	轻工、医药产品	文化体育用品	印刷品
60胶印书刊纸787X1092	轻工、医药产品	文化体育用品	印刷品
镀锌角钢5#	钢铁	钢 材、合金钢材	型材
65克轻型胶版纸1060	轻工、医药产品	纸及制品(十类)	机制纸（新闻纸）
65克轻型胶版纸840	轻工、医药产品	纸及制品(十类)	机制纸（新闻纸）
65克轻型胶版纸880	轻工、医药产品	纸及制品(十类)	机制纸（新闻纸）
95克轻型胶版纸720	轻工、医药产品	纸及制品(十类)	机制纸（新闻纸）
95克轻型胶版纸1000	轻工、医药产品	纸及制品(十类)	机制纸（新闻纸）
75克轻型胶版纸1010	轻工、医药产品	纸及制品(十类)	机制纸（新闻纸）
白方加热镀15T	钢铁	钢 材、合金钢材	管材及附件
螺纹钢十二局大同00221	钢铁	钢 材、合金钢材	线材
螺纹钢十二局大同00223	钢铁	钢 材、合金钢材	线材
螺纹钢十二局大同00224	钢铁	钢 材、合金钢材	线材
螺纹钢十二局大同00220	钢铁	钢 材、合金钢材	线材
螺纹钢十二局大同00222	钢铁	钢 材、合金钢材	线材
热镀33	钢铁	钢 材、合金钢材	管材及附件
60克轻型胶版纸880X1240	轻工、医药产品	纸及制品(十类)	机制纸（新闻纸）
41克离型原纸1650	轻工、医药产品	纸及制品(十类)	纸板（原纸）
热镀扬州	钢铁	钢 材、合金钢材	管材及附件
热镀13T	钢铁	钢 材、合金钢材	管材及附件
抗震螺纹钢	钢铁	钢 材、合金钢材	线材
热镀盖雨布	钢铁	钢 材、合金钢材	管材及附件
58克胶印书刊纸787X1092	轻工、医药产品	文化体育用品	印刷品
58克胶印书刊纸710X1000	轻工、医药产品	文化体育用品	印刷品
62克微涂胶版纸889	轻工、医药产品	纸及制品(十类)	纸板（原纸）
62克微涂胶版纸787	轻工、医药产品	纸及制品(十类)	纸板（原纸）
三角枫	钢铁	钢 材、合金钢材	型材
62克热敏原纸820	轻工、医药产品	纸及制品(十类)	其它纸及制品
热镀18t	钢铁	钢 材、合金钢材	管材及附件
58克热敏原纸1261	轻工、医药产品	纸及制品(十类)	其它纸及制品
济南骄隆济南热镀	钢铁	钢 材、合金钢材	管材及附件
透水砖	机械设备、电器	日用工业品	饮料、果菜汁
结晶糖	轻工、医药产品	饮食品	糖（固体、浆）
镀锌角钢4#	钢铁	钢 材、合金钢材	型材
汽车玻璃沈阳到河北	轻工、医药产品	日用工业品	玻璃制品
65克期刊杂志纸770	轻工、医药产品	饮食品	其它
58克热敏原纸1678	轻工、医药产品	纸及制品(十类)	其它纸及制品
58克热敏原纸1615	轻工、医药产品	纸及制品(十类)	其它纸及制品
65克离型原纸1036	轻工、医药产品	纸及制品(十类)	纸板（原纸）
65克离型原纸1040	轻工、医药产品	纸及制品(十类)	纸板（原纸）
45克无碳原纸1720	轻工、医药产品	纸及制品(十类)	其它纸及制品
70克离型原纸1036	轻工、医药产品	纸及制品(十类)	纸板（原纸）
豆瓣+促销品	粮食	杂粮	其它运输辅件及器材
豆瓣+赠品	轻工、医药产品	杂粮	其它未列名饮食及调味食品
水晶剑南春	轻工、医药产品	饮食品	饮料、果菜汁
热镀25T	钢铁	钢 材、合金钢材	管材及附件
发山东曲阜1车热方	钢铁	钢 材、合金钢材	管材及附件
热镀22T	钢铁	钢 材、合金钢材	管材及附件
汽车玻璃河北到沈阳	轻工、医药产品	日用工业品	玻璃制品
热镀管黑方	钢铁	钢 材、合金钢材	管材及附件
热镀管黑方两磅	钢铁	钢 材、合金钢材	管材及附件
70克离型原纸1036深黄	轻工、医药产品	纸及制品(十类)	纸板（原纸）
纲塑加热镀	钢铁	钢 材、合金钢材	管材及附件
64克胶印书刊纸870X1210	轻工、医药产品	文化体育用品	印刷品
热镀家焊管发鹤壁浚县	钢铁	钢 材、合金钢材	管材及附件
75克离型原纸1096	轻工、医药产品	纸及制品(十类)	纸板（原纸）
热方加方发德清	钢铁	钢 材、合金钢材	管材及附件
热方加热镀	钢铁	钢 材、合金钢材	管材及附件
方管发邯郸	钢铁	钢 材、合金钢材	管材及附件
热镀37吨1车34吨2车	钢铁	钢 材、合金钢材	管材及附件
莘县孙纪亮热镀	轻工、医药产品	饮食品	其它未列名饮食及调味食品
65克典雅纯质纸787	轻工、医药产品	纸及制品(十类)	其它纸及制品
65克典雅纯质纸1010	轻工、医药产品	纸及制品(十类)	其它纸及制品
螺旋加热镀31吨	钢铁	钢 材、合金钢材	管材及附件
65克离型原纸1195	轻工、医药产品	纸及制品(十类)	纸板（原纸）
65克离型原纸1095	轻工、医药产品	纸及制品(十类)	纸板（原纸）
黑方有定尺发河南中牟县	钢铁	钢 材、合金钢材	管材及附件
110克典雅纯质纸787	轻工、医药产品	纸及制品(十类)	其它纸及制品
110克典雅纯质纸889	轻工、医药产品	纸及制品(十类)	其它纸及制品
95克典雅纯质纸787	轻工、医药产品	纸及制品(十类)	其它纸及制品
95克典雅纯质纸889	轻工、医药产品	纸及制品(十类)	其它纸及制品
75克典雅纯质纸787	轻工、医药产品	纸及制品(十类)	其它纸及制品
75克典雅纯质纸889	轻工、医药产品	纸及制品(十类)	其它纸及制品
41克无碳复印原纸1710	轻工、医药产品	纸及制品(十类)	文教办公用品
南昌湾里32吨热镀	轻工、医药产品	专用机械、设备及制品	树木
58克轻型胶版纸700	轻工、医药产品	纸及制品(十类)	机制纸（新闻纸）
80克轻型胶版纸880	轻工、医药产品	纸及制品(十类)	机制纸（新闻纸）
60克胶印书刊纸787X1092	轻工、医药产品	文化体育用品	印刷品
90克轻型胶版纸960	轻工、医药产品	纸及制品(十类)	机制纸（新闻纸）
90克轻型胶版纸800	轻工、医药产品	纸及制品(十类)	机制纸（新闻纸）
60克胶印书刊纸90X640	轻工、医药产品	文化体育用品	印刷品
螺纹1625	钢铁	钢 材、合金钢材	线材
车方加热方加热镀	钢铁	钢 材、合金钢材	管材及附件
热镀管两地卸货	钢铁	钢 材、合金钢材	管材及附件
发石家庄黑方加热方	钢铁	钢 材、合金钢材	管材及附件
濮阳鑫瑞源螺旋加热镀	轻工、医药产品	日用工业品	饮料、果菜汁
60克全浆胶版纸886	轻工、医药产品	纸及制品(十类)	纸板（原纸）
液压支架	钢铁	钢铁制品	钢铁件及其它五金制品
新闻纸	轻工、医药产品	纸及制品(十类)	其它纸及制品
镀锌角钢和槽钢	钢铁	钢 材、合金钢材	型材
70克象牙数码纸575	轻工、医药产品	纸及制品(十类)	机制纸（新闻纸）
钢管16T	钢铁	钢 材、合金钢材	管材及附件
50克胶印书刊纸787	轻工、医药产品	文化体育用品	印刷品
58克热敏原纸1549	轻工、医药产品	纸及制品(十类)	其它纸及制品
58克热敏原纸1037	轻工、医药产品	纸及制品(十类)	其它纸及制品
汇流箱	机械设备、电器	交通运输设备	通用设备
60克胶印书刊纸870X1295	轻工、医药产品	文化体育用品	印刷品
天柏枫树80柜	农、林、牧、渔业产品	杂粮	重工业机械、工程机械及零件
78克轻型胶版纸711	轻工、医药产品	纸及制品(十类)	机制纸（新闻纸）
78克轻型胶版纸990	轻工、医药产品	纸及制品(十类)	机制纸（新闻纸）
热镀阜南两磅	钢铁	钢 材、合金钢材	管材及附件
120克离型原纸1305	轻工、医药产品	纸及制品(十类)	纸板（原纸）
100克离型原纸1555	轻工、医药产品	纸及制品(十类)	纸板（原纸）
120克离型原纸1555	轻工、医药产品	纸及制品(十类)	纸板（原纸）
120克离型原纸1050	轻工、医药产品	纸及制品(十类)	纸板（原纸）
120克离型原纸1405	轻工、医药产品	纸及制品(十类)	纸板（原纸）
120克离型原纸1860	轻工、医药产品	纸及制品(十类)	纸板（原纸）
热镀+螺旋两厂两磅	钢铁	钢 材、合金钢材	管材及附件
天柏枫树柜80	农、林、牧、渔业产品	杂粮	重工业机械、工程机械及零件
合肥宝光当涂县一车热镀两磅滁州汊河镇	轻工、医药产品	工艺美术品	雕塑、刻、漆工艺品
52克版铜原纸794	轻工、医药产品	纸及制品(十类)	其它纸及制品
热镀涡阳	钢铁	钢 材、合金钢材	管材及附件
南昌31吨热镀2车	金属矿石	钢 材、合金钢材	管材及附件
江西鄱阳县游城乡32吨热镀1车江西全通	钢铁	钢 材、合金钢材	管材及附件
方管45吨以上发长葛	钢铁	钢 材、合金钢材	管材及附件
江西鄱阳县游城乡32吨热镀	钢铁	钢 材、合金钢材	管材及附件
60克胶胶印书刊纸770	轻工、医药产品	纸及制品(十类)	机制纸（新闻纸）
6克胶印书刊纸860	轻工、医药产品	文化体育用品	印刷品
方管45吨发长葛	钢铁	钢 材、合金钢材	管材及附件
发藁城焊管热镀1车	钢铁	钢 材、合金钢材	管材及附件
60克胶印书刊纸787X1000	轻工、医药产品	文化体育用品	印刷品
60克胶印书刊纸787X645	轻工、医药产品	文化体育用品	印刷品
60克胶印书刊纸787X1100	轻工、医药产品	文化体育用品	印刷品
安庆热镀	钢铁	钢 材、合金钢材	管材及附件
直发杨浦区中原路长海路路口工地	机械设备、电器	钢 材、合金钢材	制冷、加热、燃烧设备
济南骄隆济南1车热镀	钢铁	钢 材、合金钢材	管材及附件
98克轻型胶版纸889	轻工、医药产品	纸及制品(十类)	机制纸（新闻纸）
热镀+焊管发芜湖	钢铁	钢 材、合金钢材	管材及附件
10克染色原纸893	轻工、医药产品	纸及制品(十类)	纸板（原纸）
成都瑞凌发成都3车热方	轻工、医药产品	纸及制品(十类)	其它纸及制品
青岛北方青岛1车热镀加螺旋两厂两磅	轻工、医药产品	工艺美术品	雕塑、刻、漆工艺品
钢管39T	钢铁	钢 材、合金钢材	管材及附件
80克离型原纸1200	轻工、医药产品	纸及制品(十类)	纸板（原纸）
80克离型原纸960	轻工、医药产品	纸及制品(十类)	纸板（原纸）
80克离型原纸935	轻工、医药产品	纸及制品(十类)	纸板（原纸）
100克离型原纸1200	轻工、医药产品	纸及制品(十类)	纸板（原纸）
70克离型原纸1075	轻工、医药产品	纸及制品(十类)	纸板（原纸）
西安1车热镀陕西大鹏	钢铁	钢 材、合金钢材	管材及附件
西安2车热镀陕西恒鑫孙景海	钢铁	钢 材、合金钢材	管材及附件
石家庄焊管热镀	钢铁	钢 材、合金钢材	管材及附件
合肥誉昌一车热镀合肥	轻工、医药产品	工艺美术品	雕塑、刻、漆工艺品
热镀两磅1亳州	钢铁	钢 材、合金钢材	管材及附件
南昌31吨热镀1车江西永恒	金属矿石	钢 材、合金钢材	管材及附件
70克离型原纸1400	轻工、医药产品	纸及制品(十类)	纸板（原纸）
70克离型原纸845	轻工、医药产品	纸及制品(十类)	纸板（原纸）
G钢管	钢铁	钢 材、合金钢材	管材及附件
73克离型原纸浅黄1100	轻工、医药产品	纸及制品(十类)	纸板（原纸）
太原恒帅热镀2车	钢铁	钢 材、合金钢材	管材及附件
55克胶印书刊纸1300	轻工、医药产品	文化体育用品	印刷品
80克离型原纸1105	轻工、医药产品	纸及制品(十类)	纸板（原纸）
120克离型原纸1100	轻工、医药产品	纸及制品(十类)	纸板（原纸）
100克离型原纸1050	轻工、医药产品	纸及制品(十类)	纸板（原纸）
120克离型原纸1055	轻工、医药产品	纸及制品(十类)	纸板（原纸）
67克离型原纸1313	轻工、医药产品	纸及制品(十类)	纸板（原纸）
67克离型原纸1563	轻工、医药产品	纸及制品(十类)	纸板（原纸）
67克离型原纸1413	轻工、医药产品	纸及制品(十类)	纸板（原纸）
67克离型原纸1113	轻工、医药产品	纸及制品(十类)	纸板（原纸）
73克离型原纸1053	轻工、医药产品	纸及制品(十类)	纸板（原纸）
73克离型原纸1233	轻工、医药产品	纸及制品(十类)	纸板（原纸）
70克离型原纸860	轻工、医药产品	纸及制品(十类)	纸板（原纸）
80克离型原纸990	轻工、医药产品	纸及制品(十类)	纸板（原纸）
70克离型原纸深黄1028	轻工、医药产品	纸及制品(十类)	纸板（原纸）
宁波中基惠通方钜管发大邱庄两磅	机械设备、电器	电力设备、电器机械及器材	电子、光、磁、超声波装置的元器件、零件、附件
55克胶印书书刊纸820	轻工、医药产品	文化体育用品	印刷品
橱柜	轻工、医药产品	日用工业品	家具、坐具
南昌31吨热镀南昌万溪	金属矿石	钢 材、合金钢材	管材及附件
南昌31吨热镀江西鑫淼	金属矿石	钢 材、合金钢材	管材及附件
68克离型原纸1205	轻工、医药产品	纸及制品(十类)	纸板（原纸）
55期刊杂志纸770	轻工、医药产品	饮食品	其它
平版印刷纸	轻工、医药产品	纸及制品(十类)	机制纸（新闻纸）
平版印刷用纸	轻工、医药产品	纸及制品(十类)	机制纸（新闻纸）
热方提成焊管加钢塑发十堰	钢铁	钢 材、合金钢材	管材及附件
70克轻型胶版纸880	轻工、医药产品	纸及制品(十类)	机制纸（新闻纸）
保定白沟镇热镀	轻工、医药产品	经济作物及制品	畜、禽、兽肉及制品
78克轻型胶版纸720	轻工、医药产品	纸及制品(十类)	机制纸（新闻纸）
78克轻型胶版纸710	轻工、医药产品	纸及制品(十类)	机制纸（新闻纸）
发泡空心砖	钢铁	钢 材、合金钢材	管材及附件
55克胶印书刊纸890X1240	轻工、医药产品	文化体育用品	印刷品
热镀+方管	钢铁	钢 材、合金钢材	管材及附件
67克离型原纸381X2	轻工、医药产品	纸及制品(十类)	纸板（原纸）
管坯	钢铁	钢 材、合金钢材	钢铁件及其它五金制品
67克离型原纸850	轻工、医药产品	纸及制品(十类)	纸板（原纸）
焊管+热镀发濉溪	钢铁	钢 材、合金钢材	管材及附件
60克胶印书刊纸720	轻工、医药产品	文化体育用品	印刷品
70克离型原纸浅黄1200	轻工、医药产品	纸及制品(十类)	纸板（原纸）
齿形扁钢	钢铁	钢 材、合金钢材	型材
热镀加刚塑	钢铁	钢 材、合金钢材	管材及附件
热镀两磅阜阳6+8	钢铁	钢 材、合金钢材	管材及附件
73克离型原纸945	轻工、医药产品	纸及制品(十类)	纸板（原纸）
美的冰箱	机械设备、电器	电力设备、电器机械及器材	家用电器
热镀+白方	钢铁	钢 材、合金钢材	管材及附件
75克伸性纸袋820MM	轻工、医药产品	纸及制品(十类)	机制纸（新闻纸）
75克伸性纸袋980MM	轻工、医药产品	纸及制品(十类)	机制纸（新闻纸）
75克纸袋纸760	轻工、医药产品	纸及制品(十类)	纸制品
80克纸袋纸1020	轻工、医药产品	纸及制品(十类)	纸制品
75克纸袋纸1020	轻工、医药产品	纸及制品(十类)	纸制品
啤酒瓶	轻工、医药产品	日用工业品	玻璃制品
70克轻型胶版纸710X1010	轻工、医药产品	纸及制品(十类)	机制纸（新闻纸）
65克离型原纸深黄1036	轻工、医药产品	纸及制品(十类)	纸板（原纸）
螺加焊管	钢铁	钢 材、合金钢材	钢铁件及其它五金制品
发南昌热方41T	钢铁	钢 材、合金钢材	管材及附件
75克伸行纸袋纸760	轻工、医药产品	纸及制品(十类)	纸浆
75克伸行纸袋纸980	轻工、医药产品	纸及制品(十类)	纸浆
75克伸行纸袋纸820	轻工、医药产品	纸及制品(十类)	纸浆
合肥誉昌2车热镀合肥	轻工、医药产品	工艺美术品	雕塑、刻、漆工艺品
热镀不能超过40吨	钢铁	钢 材、合金钢材	管材及附件
废铜	有色金属	铜	铜废碎料
70克轻型胶版纸889X1320	轻工、医药产品	纸及制品(十类)	机制纸（新闻纸）
80克离型原纸1255	轻工、医药产品	纸及制品(十类)	纸板（原纸）
方管发长沙	钢铁	钢 材、合金钢材	管材及附件
粘胶纤维	轻工、医药产品	针织、纺织、皮毛及制品	纱、线、丝、纤维（非复合材料）
合肥誉昌一车热镀淮北工地	轻工、医药产品	工艺美术品	雕塑、刻、漆工艺品
合肥誉昌一车热镀淮北	轻工、医药产品	工艺美术品	雕塑、刻、漆工艺品
石家庄黑方加热方	钢铁	钢 材、合金钢材	管材及附件
方管发商河	钢铁	钢 材、合金钢材	管材及附件
螺旋+热镀	钢铁	钢 材、合金钢材	管材及附件
1车热方发遵义	钢铁	钢 材、合金钢材	管材及附件
临沂李桂琴1车热镀	轻工、医药产品	工艺美术品	纸浆
电磁炉	机械设备、电器	电力设备、电器机械及器材	家用电器
成都名亿发成都1车热方	轻工、医药产品	纸及制品(十类)	其它纸及制品
55克胶印书刊纸860	轻工、医药产品	文化体育用品	印刷品
压缩机配件	机械设备、电器	普通工业机械及设备	通用设备
75克伸性纸袋纸1200	轻工、医药产品	纸及制品(十类)	机制纸（新闻纸）
75克伸性纸袋纸820	轻工、医药产品	纸及制品(十类)	机制纸（新闻纸）
槽钢工字钢	钢铁	钢 材、合金钢材	型材
80克伸性纸袋纸1020	轻工、医药产品	纸及制品(十类)	机制纸（新闻纸）
热镀燃气管	钢铁	钢 材、合金钢材	管材及附件
发吴家山41吨一车热方	钢铁	钢 材、合金钢材	其它
78克轻型胶版纸880	轻工、医药产品	纸及制品(十类)	机制纸（新闻纸）
68克轻型胶版纸880	轻工、医药产品	纸及制品(十类)	机制纸（新闻纸）
64克热敏原纸820	轻工、医药产品	纸及制品(十类)	其它纸及制品
镀方+方管发德清	钢铁	钢 材、合金钢材	管材及附件
73克离型原纸835	轻工、医药产品	纸及制品(十类)	纸板（原纸）
马牌轮胎	化工原料及制品	橡胶	橡胶制品
65克离型原纸深黄1050	轻工、医药产品	纸及制品(十类)	纸板（原纸）
68克轻型胶版纸760	轻工、医药产品	纸及制品(十类)	机制纸（新闻纸）
石家庄热方1车	钢铁	钢 材、合金钢材	管材及附件
平阴3车热镀	机械设备、电器	交通运输设备	道路机动车辆
发石家庄焊管	钢铁	钢 材、合金钢材	管材及附件
热镀+镀方	钢铁	钢 材、合金钢材	管材及附件
镀方+方管发奉贤	钢铁	钢 材、合金钢材	管材及附件
热镀4566	钢铁	钢 材、合金钢材	管材及附件
热镀焊管发西安	钢铁	钢 材、合金钢材	管材及附件
南昌31吨热镀南昌方友	金属矿石	钢 材、合金钢材	管材及附件
武汉新鑫发武汉工地一车热方	轻工、医药产品	日用工业品	机制纸（新闻纸）
襄阳永乾发襄阳一车热方	机械设备、电器	电子、电讯设备及器材	电子、光、磁、超声波装置的元器件、零件、附件
南昌31吨热镀江西众合	金属矿石	钢 材、合金钢材	管材及附件
叶腊石	非金属矿石	钢 材、合金钢材	管材及附件
兰州热镀	钢铁	钢 材、合金钢材	管材及附件
净水设备	机械设备、电器	普通工业机械及设备	通用设备
盖板	钢铁	钢 材、合金钢材	板材
55克高白胶板印刷纸880	轻工、医药产品	纸及制品(十类)	机制纸（新闻纸）
55克高白胶板印刷纸765	轻工、医药产品	纸及制品(十类)	机制纸（新闻纸）
65克高白胶板印刷纸889	轻工、医药产品	纸及制品(十类)	机制纸（新闻纸）
98克轻型胶版纸965	轻工、医药产品	纸及制品(十类)	机制纸（新闻纸）
100克轻型胶版纸889	轻工、医药产品	纸及制品(十类)	机制纸（新闻纸）
长梗	机械设备、电器	钢铁制品	其它运输辅件及器材
70克离型原纸1062	轻工、医药产品	纸及制品(十类)	纸板（原纸）
热方34点7吨发茂县	钢铁	钢 材、合金钢材	管材及附件
64克离型原纸1400	轻工、医药产品	纸及制品(十类)	纸板（原纸）
镀方+方管+热镀	钢铁	钢 材、合金钢材	管材及附件
上海铸元一车白方发浙江宁波水乡邻里	钢铁	钢 材、合金钢材	管材及附件
武汉新红发吴家山一车热方	轻工、医药产品	日用工业品	其它日用品
成都博程发成都1车热方	轻工、医药产品	其它	其它
73克离型原纸1036深黄	轻工、医药产品	纸及制品(十类)	纸板（原纸）
73克离型原纸1036	轻工、医药产品	纸及制品(十类)	纸板（原纸）
焊管加钢塑加黑方31T	钢铁	钢 材、合金钢材	管材及附件
120克离型原纸1400	轻工、医药产品	纸及制品(十类)	纸板（原纸）
南昌31吨热镀江西拓诚	金属矿石	钢 材、合金钢材	管材及附件
焊管是套管加螺旋	钢铁	钢 材、合金钢材	管材及附件
方管发黄石	钢铁	钢 材、合金钢材	管材及附件
牛肉饼	轻工、医药产品	饮食品	糕点、面食、谷物食品
方管发临沂	钢铁	钢 材、合金钢材	管材及附件
55克胶印书刊纸660X1010	轻工、医药产品	文化体育用品	印刷品
65克高白胶板印刷纸787	轻工、医药产品	纸及制品(十类)	机制纸（新闻纸）
70克高白胶板印刷纸787	轻工、医药产品	纸及制品(十类)	机制纸（新闻纸）
70克高白胶板印刷纸787x1092	轻工、医药产品	纸及制品(十类)	机制纸（新闻纸）
方管发奉贤	钢铁	钢 材、合金钢材	管材及附件
120克离型原纸930	轻工、医药产品	纸及制品(十类)	纸板（原纸）
120克离型原纸1030	轻工、医药产品	纸及制品(十类)	纸板（原纸）
80克离型原纸1308	轻工、医药产品	纸及制品(十类)	纸板（原纸）
100克离型原纸1055	轻工、医药产品	纸及制品(十类)	纸板（原纸）
方管发苏州	钢铁	钢 材、合金钢材	管材及附件
95克伸性纸袋纸1060	轻工、医药产品	纸及制品(十类)	机制纸（新闻纸）
75克轻型胶版纸889X1194	轻工、医药产品	纸及制品(十类)	机制纸（新闻纸）
75克轻型胶版纸787X1092	轻工、医药产品	纸及制品(十类)	机制纸（新闻纸）
65克轻型胶版纸889X1194	轻工、医药产品	纸及制品(十类)	机制纸（新闻纸）
武汉新红发武汉1车热方	轻工、医药产品	日用工业品	其它日用品
武汉新红发武汉热方	轻工、医药产品	日用工业品	其它日用品
楚雄1车热镀	钢铁	钢 材、合金钢材	道路机动车辆
螺纹14+25	钢铁	钢 材、合金钢材	线材
螺纹22+18	钢铁	钢 材、合金钢材	线材
55克胶印书刊纸775	轻工、医药产品	文化体育用品	印刷品
70克离型原纸浅黄1036	轻工、医药产品	纸及制品(十类)	纸板（原纸）
70克离型原纸浅黄1092	轻工、医药产品	纸及制品(十类)	纸板（原纸）
南昌31吨热镀江西全通	金属矿石	钢 材、合金钢材	管材及附件
济南+平阴两地卸1车热镀	钢铁	钢 材、合金钢材	管材及附件
发贵阳焊管+热镀33吨	钢铁	钢 材、合金钢材	管材及附件
68克轻型胶版纸870	轻工、医药产品	纸及制品(十类)	机制纸（新闻纸）
开片纸	其它货类	其它	其它
中光伏	机械设备、电器	电力设备、电器机械及器材	电子、光、磁、超声波装置的元器件、零件、附件
58克胶印书刊纸775	轻工、医药产品	文化体育用品	印刷品
58克胶印书刊纸787	轻工、医药产品	文化体育用品	印刷品
60克胶印书刊纸830	轻工、医药产品	文化体育用品	印刷品
热镀1车	钢铁	钢 材、合金钢材	管材及附件
105克染色原纸793	轻工、医药产品	纸及制品(十类)	纸板（原纸）
68克轻型胶版纸710	轻工、医药产品	纸及制品(十类)	机制纸（新闻纸）
南昌31吨热镀2车江西永恒	金属矿石	钢 材、合金钢材	管材及附件
热镀+焊	钢铁	钢 材、合金钢材	管材及附件
85克伸性纸袋纸1020	轻工、医药产品	纸及制品(十类)	机制纸（新闻纸）
发石家庄黑方加热方1车	钢铁	钢 材、合金钢材	管材及附件
65克复合胶版纸880	轻工、医药产品	纸及制品(十类)	机制纸（新闻纸）
70克离型原纸1092	轻工、医药产品	纸及制品(十类)	纸板（原纸）
建筑钢材螺纹25	钢铁	钢 材、合金钢材	条、杆、角、网、栅、丝材
热镀+螺旋820两支	钢铁	钢 材、合金钢材	管材及附件
60克胶印书刊纸440X2	轻工、医药产品	文化体育用品	印刷品
68克轻型胶版纸1000	轻工、医药产品	纸及制品(十类)	机制纸（新闻纸）
70克轻型胶版纸965	轻工、医药产品	纸及制品(十类)	机制纸（新闻纸）
96克轻型胶版纸889	轻工、医药产品	纸及制品(十类)	机制纸（新闻纸）
肉	农、林、牧、渔业产品	畜、禽、兽及制品	畜、禽、兽肉及制品
禹城1车热镀	钢铁	钢 材、合金钢材	管材及附件
平阴1车焊管+钢塑	钢铁	钢 材、合金钢材	管材及附件
75克纸袋纸920	轻工、医药产品	纸及制品(十类)	纸制品
68克离型原纸1045	轻工、医药产品	纸及制品(十类)	纸板（原纸）
车方热方发宁波	钢铁	钢 材、合金钢材	管材及附件
杨木化机浆	轻工、医药产品	纸及制品(十类)	家具、坐具
68克离型原纸1248	轻工、医药产品	纸及制品(十类)	纸板（原纸）
螺纹25E18E	钢铁	钢 材、合金钢材	线材
螺纹12E	钢铁	钢 材、合金钢材	线材
68克轻型胶版纸860X1184	轻工、医药产品	纸及制品(十类)	机制纸（新闻纸）
螺纹22E	钢铁	钢 材、合金钢材	线材
58克胶印书刊纸755	轻工、医药产品	文化体育用品	印刷品
75克伸性纸袋纸760	轻工、医药产品	纸及制品(十类)	机制纸（新闻纸）
75克伸性纸袋纸1020	轻工、医药产品	纸及制品(十类)	机制纸（新闻纸）
80克伸性纸袋纸1120	轻工、医药产品	纸及制品(十类)	机制纸（新闻纸）
80克伸性纸袋纸1220	轻工、医药产品	纸及制品(十类)	机制纸（新闻纸）
1919酒	轻工、医药产品	饮食品	酒（白酒、啤酒、果酒类）
合肥加热方发德清	钢铁	钢 材、合金钢材	管材及附件
65克轻型胶版纸680	轻工、医药产品	纸及制品(十类)	机制纸（新闻纸）
黑方热方发杭州	钢铁	钢 材、合金钢材	管材及附件
黑方热方发德清	钢铁	钢 材、合金钢材	管材及附件
组串式逆变器	其它货类	针织、纺织、皮毛及制品	服装
方管发宜昌码头	钢铁	钢 材、合金钢材	管材及附件
117克胶印书刊纸889	轻工、医药产品	文化体育用品	印刷品
方管发阜阳	钢铁	钢 材、合金钢材	管材及附件
60克食品纸916	轻工、医药产品	纸及制品(十类)	其它纸及制品
南昌热镀4车江西全通	钢铁	钢 材、合金钢材	管材及附件
南昌热镀4车江西拓源	钢铁	钢 材、合金钢材	管材及附件
南昌热镀1车江西全通	钢铁	钢 材、合金钢材	管材及附件
热圆	钢铁	钢 材、合金钢材	线材
68克离型原纸1098	轻工、医药产品	纸及制品(十类)	纸板（原纸）
50克胶印书刊纸860	轻工、医药产品	文化体育用品	印刷品
65克复合原纸886	轻工、医药产品	纸及制品(十类)	其它纸及制品
55克胶印书刊纸710X1000	轻工、医药产品	文化体育用品	印刷品
70克离型原纸1098浅黄	轻工、医药产品	纸及制品(十类)	纸板（原纸）
无碳原纸	轻工、医药产品	纸及制品(十类)	其它纸及制品
无碳原纸等	轻工、医药产品	纸及制品(十类)	其它纸及制品
65克轻型胶版纸870	轻工、医药产品	纸及制品(十类)	机制纸（新闻纸）
65克复合胶版纸35	轻工、医药产品	纸及制品(十类)	机制纸（新闻纸）
68克离型原纸1200	轻工、医药产品	纸及制品(十类)	纸板（原纸）
60克胶印书刊纸780X1092	轻工、医药产品	文化体育用品	印刷品
55克胶印书刊纸880X1250	轻工、医药产品	文化体育用品	印刷品
68克轻型胶版纸765	轻工、医药产品	纸及制品(十类)	机制纸（新闻纸）
龙钢螺纹	钢铁	钢 材、合金钢材	线材
60克轻型胶版纸870	轻工、医药产品	纸及制品(十类)	机制纸（新闻纸）
120克离型原纸1105	轻工、医药产品	纸及制品(十类)	纸板（原纸）
螺纹16E22E	钢铁	钢 材、合金钢材	线材
400E12螺纹	钢铁	钢 材、合金钢材	线材
美菱冰箱	机械设备、电器	电力设备、电器机械及器材	家用电器
80克伸性纸袋纸760	轻工、医药产品	纸及制品(十类)	机制纸（新闻纸）
80克伸性纸袋纸830	轻工、医药产品	纸及制品(十类)	机制纸（新闻纸）
80克伸性纸袋纸1190	轻工、医药产品	纸及制品(十类)	机制纸（新闻纸）
80克伸性纸袋纸790	轻工、医药产品	纸及制品(十类)	机制纸（新闻纸）
70克离型原纸深典1036	轻工、医药产品	纸及制品(十类)	纸板（原纸）
400E16螺纹	钢铁	钢 材、合金钢材	线材
晋钢400E12螺纹	钢铁	钢 材、合金钢材	线材
65克复合胶版纸770	轻工、医药产品	纸及制品(十类)	机制纸（新闻纸）
65克复合胶版纸870	轻工、医药产品	纸及制品(十类)	机制纸（新闻纸）
80克伸性纸袋纸1040	轻工、医药产品	纸及制品(十类)	机制纸（新闻纸）
80克伸性纸袋纸1250	轻工、医药产品	纸及制品(十类)	机制纸（新闻纸）
80克伸性纸袋纸1140	轻工、医药产品	纸及制品(十类)	机制纸（新闻纸）
70克纸袋纸780	轻工、医药产品	纸及制品(十类)	纸制品
80克纸袋纸787	轻工、医药产品	纸及制品(十类)	纸制品
80克伸性纸袋纸1090	轻工、医药产品	纸及制品(十类)	机制纸（新闻纸）
晋钢400E25螺纹	钢铁	钢 材、合金钢材	线材
晋钢400E16螺纹	钢铁	钢 材、合金钢材	线材
晋钢400E18螺纹	钢铁	钢 材、合金钢材	线材
56克轻型胶版纸865	轻工、医药产品	纸及制品(十类)	机制纸（新闻纸）
75克伸性纸袋纸980	轻工、医药产品	纸及制品(十类)	机制纸（新闻纸）
80克伸性纸袋纸840	轻工、医药产品	纸及制品(十类)	机制纸（新闻纸）
方管	钢铁	钢 材、合金钢材	管材及附件
80克轻型胶版纸710X1000	轻工、医药产品	纸及制品(十类)	机制纸（新闻纸）
热镀管+方矩管	钢铁	钢 材、合金钢材	管材及附件
80克微涂胶版纸710X1000	轻工、医药产品	纸及制品(十类)	纸板（原纸）
70克微涂胶版纸880X1230	轻工、医药产品	纸及制品(十类)	纸板（原纸）
70克微涂胶版纸710X1000	轻工、医药产品	纸及制品(十类)	纸板（原纸）
68克轻型胶版纸770	轻工、医药产品	纸及制品(十类)	机制纸（新闻纸）
80克伸性纸袋纸780	轻工、医药产品	纸及制品(十类)	机制纸（新闻纸）
圆管发德清	钢铁	钢 材、合金钢材	管材及附件
70克伸性纸袋纸780	轻工、医药产品	纸及制品(十类)	机制纸（新闻纸）
贝雷片	化工原料及制品	其它未列名化工原料及制品	其它
晋钢400E1612米螺纹	钢铁	钢 材、合金钢材	线材
圆管发襄阳	钢铁	钢 材、合金钢材	管材及附件
晋钢400E螺纹拼车	钢铁	钢 材、合金钢材	线材
晋钢400E18螺纹15件	钢铁	钢 材、合金钢材	线材
65克复合胶版纸880X1240	轻工、医药产品	纸及制品(十类)	机制纸（新闻纸）
70克伸性纸袋纸1020	轻工、医药产品	纸及制品(十类)	机制纸（新闻纸）
方管发武昌	钢铁	钢 材、合金钢材	管材及附件
圆管发淮南	钢铁	钢 材、合金钢材	管材及附件
晋钢400E18螺纹14件	钢铁	钢 材、合金钢材	线材
100克伸性纸袋纸1020	轻工、医药产品	纸及制品(十类)	机制纸（新闻纸）
90克伸性纸袋纸1020	轻工、医药产品	纸及制品(十类)	机制纸（新闻纸）
135克典雅纯质纸889	轻工、医药产品	纸及制品(十类)	其它纸及制品
135克典雅纯质纸787	轻工、医药产品	纸及制品(十类)	其它纸及制品
邯郸市冰川热镀16吨	钢铁	钢 材、合金钢材	管材及附件
邯郸市康腾热镀16吨	钢铁	钢 材、合金钢材	板材
75克伸性纸袋纸1120	轻工、医药产品	纸及制品(十类)	机制纸（新闻纸）
邢台安顺热镀40吨	钢铁	钢 材、合金钢材	管材及附件
70克轻型胶版纸960x705+705x960	轻工、医药产品	纸及制品(十类)	机制纸（新闻纸）
热镀方矩管+方矩管+热镀管	钢铁	钢 材、合金钢材	管材及附件
80克伸性纸袋纸740	轻工、医药产品	纸及制品(十类)	机制纸（新闻纸）
78克轻型胶版纸1004	轻工、医药产品	纸及制品(十类)	机制纸（新闻纸）
88克轻型胶版纸880	轻工、医药产品	纸及制品(十类)	机制纸（新闻纸）
100克伸性纸袋纸1060	轻工、医药产品	纸及制品(十类)	机制纸（新闻纸）
晋钢400E16螺纹15件	钢铁	钢 材、合金钢材	线材
晋钢400E12螺纹18件	钢铁	钢 材、合金钢材	线材
热镀方矩管＋方矩管	钢铁	钢 材、合金钢材	管材及附件
悍管＋热镀管	钢铁	钢 材、合金钢材	管材及附件
热镀方军管	钢铁	钢 材、合金钢材	管材及附件
400E螺纹25	钢铁	钢 材、合金钢材	线材
螺纹400E20	钢铁	钢 材、合金钢材	线材
400E20螺纹	钢铁	钢 材、合金钢材	线材
螺纹400E12	钢铁	钢 材、合金钢材	线材
螺纹400E16	钢铁	钢 材、合金钢材	线材
晋钢400E20螺纹13件	钢铁	钢 材、合金钢材	线材
80克纸袋纸1300	轻工、医药产品	纸及制品(十类)	纸制品
80克纸袋纸1400	轻工、医药产品	纸及制品(十类)	纸制品
方管发光谷	钢铁	钢 材、合金钢材	管材及附件
400E18螺纹	钢铁	钢 材、合金钢材	线材
90克伸性纸袋纸2210	轻工、医药产品	纸及制品(十类)	机制纸（新闻纸）
80克轻型胶版纸711	轻工、医药产品	纸及制品(十类)	机制纸（新闻纸）
热镀方矩管管	钢铁	钢 材、合金钢材	管材及附件
热镀33吨	钢铁	钢 材、合金钢材	管材及附件
400E螺纹	钢铁	钢 材、合金钢材	线材
75克轻型胶版纸640	轻工、医药产品	纸及制品(十类)	机制纸（新闻纸）
78克轻型胶版纸720X1004	轻工、医药产品	纸及制品(十类)	机制纸（新闻纸）
78克轻型胶版纸1004X720	轻工、医药产品	纸及制品(十类)	机制纸（新闻纸）
焊+热镀	钢铁	钢 材、合金钢材	管材及附件
晋钢400E25螺纹13件	钢铁	钢 材、合金钢材	线材
75克纸袋纸830	轻工、医药产品	纸及制品(十类)	纸制品
75克纸袋纸790	轻工、医药产品	纸及制品(十类)	纸制品
工字钢槽钢	钢铁	钢 材、合金钢材	型材
焊热镀管	钢铁	钢 材、合金钢材	管材及附件
75克纸袋纸1060	轻工、医药产品	纸及制品(十类)	纸制品
75克纸袋纸1185	轻工、医药产品	纸及制品(十类)	纸制品
70克纸袋纸1500	轻工、医药产品	纸及制品(十类)	纸制品
70克纸袋纸1530	轻工、医药产品	纸及制品(十类)	纸制品
晋钢400E20螺纹	钢铁	钢 材、合金钢材	线材
热镀管+螺旋	钢铁	钢 材、合金钢材	管材及附件
80克纸袋纸820	轻工、医药产品	纸及制品(十类)	纸制品
80克纸袋纸1200	轻工、医药产品	纸及制品(十类)	纸制品
80克纸袋纸1120	轻工、医药产品	纸及制品(十类)	纸制品
70克轻型胶版纸710x960	轻工、医药产品	纸及制品(十类)	机制纸（新闻纸）
68克轻型胶版纸550	轻工、医药产品	纸及制品(十类)	机制纸（新闻纸）
58克轻型胶版纸550	轻工、医药产品	纸及制品(十类)	机制纸（新闻纸）
80克伸性纸袋纸960	轻工、医药产品	纸及制品(十类)	机制纸（新闻纸）
r热镀方矩管	钢铁	钢 材、合金钢材	管材及附件
65克轻型胶版纸990	轻工、医药产品	纸及制品(十类)	机制纸（新闻纸）
80克微涂胶版纸880x1230	轻工、医药产品	纸及制品(十类)	纸板（原纸）
邢台顺达白方加热镀38吨	轻工、医药产品	日用工业品	文化办公机械、设备
68克离型原纸1210	轻工、医药产品	纸及制品(十类)	纸板（原纸）
晋钢400E14螺纹	钢铁	钢 材、合金钢材	线材
热镀管+焊+方矩管	钢铁	钢 材、合金钢材	管材及附件
方管发南阳宛城	钢铁	钢 材、合金钢材	管材及附件
方管发郑州	钢铁	钢 材、合金钢材	管材及附件
角钢工字钢	钢铁	钢 材、合金钢材	型材
圆管发芜湖	钢铁	钢 材、合金钢材	管材及附件
晋钢400E22螺纹	钢铁	钢 材、合金钢材	线材
兰炭中料	轻工、医药产品	纸及制品(十类)	橡胶制品
75克纸袋纸990	轻工、医药产品	纸及制品(十类)	纸制品
75克伸性纸袋纸990	轻工、医药产品	纸及制品(十类)	机制纸（新闻纸）
80克微涂胶版纸889X1194	轻工、医药产品	纸及制品(十类)	纸板（原纸）
55克胶印书刊纸880X1260	轻工、医药产品	文化体育用品	印刷品
55克胶印书刊纸880X1230	轻工、医药产品	文化体育用品	印刷品
90克伸性纸袋纸780	轻工、医药产品	纸及制品(十类)	机制纸（新闻纸）
70克离型原纸950	轻工、医药产品	纸及制品(十类)	纸板（原纸）
60克轻型胶版纸880X1250	轻工、医药产品	纸及制品(十类)	机制纸（新闻纸）
60克轻型胶版纸880X780	轻工、医药产品	纸及制品(十类)	机制纸（新闻纸）
65克轻型胶版纸787X1092	轻工、医药产品	纸及制品(十类)	机制纸（新闻纸）
70克轻型胶版纸880X1170	轻工、医药产品	纸及制品(十类)	机制纸（新闻纸）
晋钢400E28螺纹	钢铁	钢 材、合金钢材	线材
晋钢400E32螺纹	钢铁	钢 材、合金钢材	线材
67克离型原纸1040	轻工、医药产品	纸及制品(十类)	纸板（原纸）
75克纸袋纸1300	轻工、医药产品	纸及制品(十类)	纸制品
75克纸袋纸1400	轻工、医药产品	纸及制品(十类)	纸制品
80克伸性纸袋纸1260	轻工、医药产品	纸及制品(十类)	机制纸（新闻纸）
方管发荆州	钢铁	钢 材、合金钢材	管材及附件
68克轻型胶版纸820	轻工、医药产品	纸及制品(十类)	机制纸（新闻纸）
70克纸袋纸1240	轻工、医药产品	纸及制品(十类)	纸制品
100克伸性纸袋纸1010	轻工、医药产品	纸及制品(十类)	机制纸（新闻纸）
果树专用复合肥	肥料及农药	化 肥	其它
60克胶印书刊纸730	轻工、医药产品	文化体育用品	印刷品
80克纸袋纸760	轻工、医药产品	纸及制品(十类)	纸制品
75克纸袋纸889	轻工、医药产品	纸及制品(十类)	纸制品
75克纸袋纸787	轻工、医药产品	纸及制品(十类)	纸制品
80克伸性纸袋纸787	轻工、医药产品	纸及制品(十类)	机制纸（新闻纸）
方管发九江浔阳	钢铁	钢 材、合金钢材	管材及附件
维克特瑞马来矿	轻工、医药产品	针织、纺织、皮毛及制品	印刷品
70克纸袋纸710	轻工、医药产品	纸及制品(十类)	纸制品
75克离型原纸1098	轻工、医药产品	纸及制品(十类)	纸板（原纸）
方管发武汉	钢铁	钢 材、合金钢材	管材及附件
58克热敏原纸1243	轻工、医药产品	纸及制品(十类)	其它纸及制品
58克热敏原纸1249	轻工、医药产品	纸及制品(十类)	其它纸及制品
78克胶印书刊纸880	轻工、医药产品	文化体育用品	印刷品
75克纸袋纸1120	轻工、医药产品	纸及制品(十类)	纸制品
95克伸性纸袋纸1010	轻工、医药产品	纸及制品(十类)	机制纸（新闻纸）
方矩管+热镀管	钢铁	钢 材、合金钢材	管材及附件
邯郸市康腾热镀18吨	钢铁	钢 材、合金钢材	板材
73克离型原纸1020	轻工、医药产品	纸及制品(十类)	纸板（原纸）
方矩管 热镀方矩管	钢铁	钢 材、合金钢材	管材及附件
70克数码印刷纸590	轻工、医药产品	纸及制品(十类)	机制纸（新闻纸）
70克数码印刷纸648	轻工、医药产品	纸及制品(十类)	机制纸（新闻纸）
螺纹12E14E16E25E	钢铁	钢 材、合金钢材	线材
70克伸性纸袋纸790	轻工、医药产品	纸及制品(十类)	机制纸（新闻纸）
70克离型原纸深典1028	轻工、医药产品	纸及制品(十类)	纸板（原纸）
70克微涂胶版纸787X1092	轻工、医药产品	纸及制品(十类)	纸板（原纸）
80克微涂胶版纸787X1092	轻工、医药产品	纸及制品(十类)	纸板（原纸）
70克微涂胶版纸889X1194	轻工、医药产品	纸及制品(十类)	纸板（原纸）
圆管发宜昌	钢铁	钢 材、合金钢材	管材及附件
钢板水陆联运	钢铁	钢 材、合金钢材	板材
热镀管方矩管方矩管	钢铁	钢 材、合金钢材	管材及附件
70克轻型胶版纸730X1020	轻工、医药产品	纸及制品(十类)	机制纸（新闻纸）
方管发芜湖	钢铁	钢 材、合金钢材	管材及附件
75克伸性纸袋纸920	轻工、医药产品	纸及制品(十类)	机制纸（新闻纸）
75克伸性纸袋纸1240	轻工、医药产品	纸及制品(十类)	机制纸（新闻纸）
75克伸性纸袋纸730	轻工、医药产品	纸及制品(十类)	机制纸（新闻纸）
75克伸性纸袋纸1060	轻工、医药产品	纸及制品(十类)	机制纸（新闻纸）
75克伸性纸袋纸1260	轻工、医药产品	纸及制品(十类)	机制纸（新闻纸）
75克伸性纸袋纸700	轻工、医药产品	纸及制品(十类)	机制纸（新闻纸）
方热镀	钢铁	钢 材、合金钢材	管材及附件
平版双胶纸	轻工、医药产品	纸及制品(十类)	纸板（原纸）
汽车玻璃沈阳到河北2	轻工、医药产品	日用工业品	玻璃制品
方矩管+热镀	钢铁	钢 材、合金钢材	管材及附件
95克精品牛皮889	轻工、医药产品	纸及制品(十类)	纸制品
热镀+方矩管+热镀方矩管	钢铁	钢 材、合金钢材	管材及附件
电机运输	其它货类	普通工业机械及设备	重工业机械、工程机械及零件
80克轻型胶版纸720	轻工、医药产品	纸及制品(十类)	机制纸（新闻纸）
80克轻型胶版纸1004	轻工、医药产品	纸及制品(十类)	机制纸（新闻纸）
75克纸袋纸1040	轻工、医药产品	纸及制品(十类)	纸制品
螺纹25E	钢铁	钢 材、合金钢材	线材
螺纹20E	钢铁	钢 材、合金钢材	线材
75克伸性纸袋纸1600	轻工、医药产品	纸及制品(十类)	机制纸（新闻纸）
80克纸袋纸740	轻工、医药产品	纸及制品(十类)	纸制品
75克纸袋纸730	轻工、医药产品	纸及制品(十类)	纸制品
80克纸袋纸830	轻工、医药产品	纸及制品(十类)	纸制品
75克纸袋纸1180	轻工、医药产品	纸及制品(十类)	纸制品
圆管发大邱庄	钢铁	钢 材、合金钢材	管材及附件
80克纸袋纸770	轻工、医药产品	纸及制品(十类)	纸制品
白方+热镀	钢铁	钢 材、合金钢材	管材及附件
100克纸袋纸1010	轻工、医药产品	纸及制品(十类)	纸制品
方管发余杭	钢铁	钢 材、合金钢材	管材及附件
圆管发武昌	钢铁	钢 材、合金钢材	管材及附件
880克伸性纸袋纸1020	轻工、医药产品	纸及制品(十类)	机制纸（新闻纸）
67克胶印书刊纸889	轻工、医药产品	文化体育用品	印刷品
65克复合胶版纸787X1092	轻工、医药产品	纸及制品(十类)	机制纸（新闻纸）
70克胶印书刊纸870	轻工、医药产品	文化体育用品	印刷品
螺旋+热镀管	钢铁	钢 材、合金钢材	管材及附件
80克纸袋纸1080	轻工、医药产品	纸及制品(十类)	纸制品
80克轻型胶版纸870	轻工、医药产品	纸及制品(十类)	机制纸（新闻纸）
68克轻型胶版纸920	轻工、医药产品	纸及制品(十类)	机制纸（新闻纸）
70克纸袋纸1020	轻工、医药产品	纸及制品(十类)	纸制品
65克轻型胶版纸640	轻工、医药产品	纸及制品(十类)	机制纸（新闻纸）
75克轻型胶版纸980	轻工、医药产品	纸及制品(十类)	机制纸（新闻纸）
75克轻型胶版纸970	轻工、医药产品	纸及制品(十类)	机制纸（新闻纸）
58克轻型胶版纸710	轻工、医药产品	纸及制品(十类)	机制纸（新闻纸）
58克轻型胶版纸787	轻工、医药产品	纸及制品(十类)	机制纸（新闻纸）
70克防锈原纸2270	轻工、医药产品	纸及制品(十类)	纸板（原纸）
75克防锈原纸1430	轻工、医药产品	纸及制品(十类)	纸板（原纸）
75克防锈原纸2030	轻工、医药产品	纸及制品(十类)	纸板（原纸）
75克防锈原纸1830	轻工、医药产品	纸及制品(十类)	纸板（原纸）
75克防锈原纸2230	轻工、医药产品	纸及制品(十类)	纸板（原纸）
60克防锈原纸	轻工、医药产品	纸及制品(十类)	纸板（原纸）
60克防锈原纸1630	轻工、医药产品	纸及制品(十类)	纸板（原纸）
115克精品牛皮889	轻工、医药产品	纸及制品(十类)	纸制品
75克防锈原纸787	轻工、医药产品	纸及制品(十类)	纸板（原纸）
80克纸袋纸950	轻工、医药产品	纸及制品(十类)	纸制品
75克纸袋纸750	轻工、医药产品	纸及制品(十类)	纸制品
圆管发十堰	钢铁	钢 材、合金钢材	管材及附件
热镀管+热镀方矩管	钢铁	钢 材、合金钢材	管材及附件
90克伸性纸袋纸840	轻工、医药产品	纸及制品(十类)	机制纸（新闻纸）
95克纸袋纸787	轻工、医药产品	纸及制品(十类)	纸制品
75克纸袋纸1194	轻工、医药产品	纸及制品(十类)	纸制品
80克纸袋纸1220	轻工、医药产品	纸及制品(十类)	纸制品
70克纸袋纸1400	轻工、医药产品	纸及制品(十类)	纸制品
70克纸袋纸830	轻工、医药产品	纸及制品(十类)	纸制品
TCL洗衣机	机械设备、电器	电力设备、电器机械及器材	家用电器
80克伸性纸袋1260	轻工、医药产品	纸及制品(十类)	机制纸（新闻纸）
80克伸性纸袋纸1240	轻工、医药产品	纸及制品(十类)	机制纸（新闻纸）
70克离型原纸浅黄1198	轻工、医药产品	纸及制品(十类)	纸板（原纸）
70克离型原纸浅黄1098	轻工、医药产品	纸及制品(十类)	纸板（原纸）
70克离型原纸浅黄1028	轻工、医药产品	纸及制品(十类)	纸板（原纸）
77克涂布纸纯质纸889	轻工、医药产品	纸及制品(十类)	机制纸（新闻纸）
67克涂布纸纯质纸880	轻工、医药产品	纸及制品(十类)	机制纸（新闻纸）
67克涂布纸纯质纸1000	轻工、医药产品	纸及制品(十类)	机制纸（新闻纸）
70克轻型胶版纸700x1000	轻工、医药产品	纸及制品(十类)	机制纸（新闻纸）
58克轻型胶版纸787X1092	轻工、医药产品	纸及制品(十类)	机制纸（新闻纸）
58克轻型胶版纸889X1194	轻工、医药产品	纸及制品(十类)	机制纸（新闻纸）
12米螺纹钢	钢铁	钢 材、合金钢材	线材
容声冰箱	机械设备、电器	电力设备、电器机械及器材	家用电器
A螺旋管热镀管	钢铁	钢 材、合金钢材	管材及附件
螺旋管+热镀管	钢铁	钢 材、合金钢材	管材及附件
热镀管+热镀方矩管+方矩管	钢铁	钢 材、合金钢材	管材及附件
56克胶印书刊纸865	轻工、医药产品	文化体育用品	印刷品
77克涂布纸纯质纸787X1092	轻工、医药产品	纸及制品(十类)	机制纸（新闻纸）
80克纸袋纸790	轻工、医药产品	纸及制品(十类)	纸制品
70克轻型胶版纸1000X710	轻工、医药产品	纸及制品(十类)	机制纸（新闻纸）
58克轻型胶版纸775	轻工、医药产品	纸及制品(十类)	机制纸（新闻纸）
热镀方矩馆	钢铁	钢 材、合金钢材	管材及附件
热镀方矩管+热镀	钢铁	钢 材、合金钢材	管材及附件
热轧钢带	钢铁	钢铁制品	钢铁件及其它五金制品
70克离型原纸1128深黄	轻工、医药产品	纸及制品(十类)	纸板（原纸）
热镀+热镀方矩管	钢铁	钢 材、合金钢材	管材及附件
烟梗	农、林、牧、渔业产品	经济作物及制品	经济作物原料、残渣及副产品
68克离型原纸1036	轻工、医药产品	纸及制品(十类)	纸板（原纸）
95克高白胶板印刷纸787	轻工、医药产品	纸及制品(十类)	机制纸（新闻纸）
95克高白胶板印刷纸889	轻工、医药产品	纸及制品(十类)	机制纸（新闻纸）
60克数码印刷纸440	轻工、医药产品	纸及制品(十类)	机制纸（新闻纸）
75克纸袋纸1080	轻工、医药产品	纸及制品(十类)	纸制品
热镀管+方矩管+热镀方矩管	钢铁	钢 材、合金钢材	管材及附件
80克纸袋纸970	轻工、医药产品	纸及制品(十类)	纸制品
80克轻型胶版纸960X710	轻工、医药产品	纸及制品(十类)	机制纸（新闻纸）
白方配热镀	钢铁	钢 材、合金钢材	管材及附件
115克精品牛皮787	轻工、医药产品	纸及制品(十类)	纸制品
60克轻型胶版纸700X1000	轻工、医药产品	纸及制品(十类)	机制纸（新闻纸）
70克纸袋纸1120	轻工、医药产品	纸及制品(十类)	纸制品
80克纸袋纸940	轻工、医药产品	纸及制品(十类)	纸制品
钢管34T	钢铁	钢 材、合金钢材	管材及附件
钢管50T	钢铁	钢 材、合金钢材	管材及附件
针织机	机械设备、电器	专用机械、设备及制品	重工业机械、工程机械及零件
纸浆版	轻工、医药产品	纸及制品(十类)	纸浆
锅炉配件	其它货类	其它	其它
80克轻型胶版纸710X960	轻工、医药产品	纸及制品(十类)	机制纸（新闻纸）
60克防锈原纸787	轻工、医药产品	纸及制品(十类)	纸板（原纸）
70克防锈原纸787	轻工、医药产品	纸及制品(十类)	纸板（原纸）
75克防锈原纸3140	轻工、医药产品	纸及制品(十类)	纸板（原纸）
75克防锈原纸1250	轻工、医药产品	纸及制品(十类)	纸板（原纸）
75克防锈原纸1020	轻工、医药产品	纸及制品(十类)	纸板（原纸）
75克防锈原纸900	轻工、医药产品	纸及制品(十类)	纸板（原纸）
热镀热镀方矩管	钢铁	钢 材、合金钢材	管材及附件
80克纸袋纸900	轻工、医药产品	纸及制品(十类)	纸制品
70克伸性纸袋纸730	轻工、医药产品	纸及制品(十类)	机制纸（新闻纸）
80克纸袋纸840	轻工、医药产品	纸及制品(十类)	纸制品
75克伸性纸袋纸1092	轻工、医药产品	纸及制品(十类)	机制纸（新闻纸）
75克纸袋纸	轻工、医药产品	纸及制品(十类)	纸制品
80克伸性纸袋纸1170	轻工、医药产品	纸及制品(十类)	机制纸（新闻纸）
空调和柜子	轻工、医药产品	电力设备、电器机械及器材	家用电器
红茶	轻工、医药产品	饮食品	饮料、果菜汁
60克胶印书刊纸870x1140	轻工、医药产品	文化体育用品	印刷品
68克胶印书刊纸870x1295	轻工、医药产品	文化体育用品	印刷品
68克胶印书刊纸870x1200	轻工、医药产品	文化体育用品	印刷品
80克轻型胶版纸977x1092	轻工、医药产品	纸及制品(十类)	机制纸（新闻纸）
鸡尾酒	轻工、医药产品	饮食品	酒（白酒、啤酒、果酒类）
圆管发亳州	钢铁	钢 材、合金钢材	管材及附件
圆管发长垣	钢铁	钢 材、合金钢材	管材及附件
热镀管热镀管	钢铁	钢 材、合金钢材	管材及附件
镀锌焊管冀DL7639	钢铁	钢 材、合金钢材	管材及附件
80克纸袋纸800	轻工、医药产品	纸及制品(十类)	纸制品
70克离型原纸深黄1058深黄	轻工、医药产品	纸及制品(十类)	纸板（原纸）
80克伸性纸袋纸880	轻工、医药产品	纸及制品(十类)	机制纸（新闻纸）
68克轻型胶版纸880X1230	轻工、医药产品	纸及制品(十类)	机制纸（新闻纸）
60克防锈原纸1530	轻工、医药产品	纸及制品(十类)	纸板（原纸）
78克轻型胶版纸890	轻工、医药产品	纸及制品(十类)	机制纸（新闻纸）
0克轻型胶版纸960X710	轻工、医药产品	纸及制品(十类)	机制纸（新闻纸）
70克轻型胶版纸977X1092	轻工、医药产品	纸及制品(十类)	机制纸（新闻纸）
73克离型原纸1183	轻工、医药产品	纸及制品(十类)	纸板（原纸）
100克涂布纸质纸720X880	轻工、医药产品	纸及制品(十类)	机制纸（新闻纸）
100克涂布纸质纸720X1000	轻工、医药产品	纸及制品(十类)	机制纸（新闻纸）
68克离型原纸1245	轻工、医药产品	纸及制品(十类)	纸板（原纸）
热镀方矩管   热镀管	钢铁	钢 材、合金钢材	管材及附件
80克伸性纸袋纸2240	轻工、医药产品	纸及制品(十类)	机制纸（新闻纸）
75克伸性纸袋纸889	轻工、医药产品	纸及制品(十类)	机制纸（新闻纸）
78克离型原纸1205	轻工、医药产品	纸及制品(十类)	纸板（原纸）
58克高白胶板印刷纸1205	轻工、医药产品	纸及制品(十类)	机制纸（新闻纸）
58克高白胶板印刷纸1425	轻工、医药产品	纸及制品(十类)	机制纸（新闻纸）
热镀管 热镀方矩管	钢铁	钢 材、合金钢材	管材及附件
75克伸性纸袋纸1030	轻工、医药产品	纸及制品(十类)	机制纸（新闻纸）
75克伸性纸袋纸1040	轻工、医药产品	纸及制品(十类)	机制纸（新闻纸）
圆管发濮阳	钢铁	钢 材、合金钢材	管材及附件
方矩管＋热镀方矩管	钢铁	钢 材、合金钢材	管材及附件
器具料架	轻工、医药产品	日用工业品	其它
圆管发阜阳	钢铁	钢 材、合金钢材	管材及附件
热镀方矩管 方矩管	钢铁	钢 材、合金钢材	管材及附件
90克伸性纸袋纸1060	轻工、医药产品	纸及制品(十类)	机制纸（新闻纸）
85克伸性纸袋纸1060	轻工、医药产品	纸及制品(十类)	机制纸（新闻纸）
67克离型原纸1050	轻工、医药产品	纸及制品(十类)	纸板（原纸）
55克胶印书刊纸889	轻工、医药产品	文化体育用品	印刷品
70克伸性纸袋纸1010	轻工、医药产品	纸及制品(十类)	机制纸（新闻纸）
75克纸袋纸1425	轻工、医药产品	纸及制品(十类)	纸制品
75克纸袋纸1440	轻工、医药产品	纸及制品(十类)	纸制品
70克纸袋纸770	轻工、医药产品	纸及制品(十类)	纸制品
80克纸袋纸1240	轻工、医药产品	纸及制品(十类)	纸制品
75克纸袋纸1092	轻工、医药产品	纸及制品(十类)	纸制品
95克纸袋纸1092	轻工、医药产品	纸及制品(十类)	纸制品
70克纸袋纸790	轻工、医药产品	纸及制品(十类)	纸制品
60克数码印刷纸590	轻工、医药产品	纸及制品(十类)	机制纸（新闻纸）
60克轻型胶版纸890x1240	轻工、医药产品	纸及制品(十类)	机制纸（新闻纸）
圆管发兰州	钢铁	钢 材、合金钢材	管材及附件
75克纸袋纸2100	轻工、医药产品	纸及制品(十类)	纸制品
80克伸性纸袋纸930	轻工、医药产品	纸及制品(十类)	机制纸（新闻纸）
80克伸性纸袋纸950	轻工、医药产品	纸及制品(十类)	机制纸（新闻纸）
80克纸袋纸750	轻工、医药产品	纸及制品(十类)	纸制品
80克伸性纸袋纸690	轻工、医药产品	纸及制品(十类)	机制纸（新闻纸）
卡拉宾针叶浆	化工原料及制品	工艺美术品	普通金属工艺品
58克胶印书刊纸760	轻工、医药产品	文化体育用品	印刷品
78克数码印刷纸648	轻工、医药产品	纸及制品(十类)	机制纸（新闻纸）
热镀方矩方矩管	钢铁	钢 材、合金钢材	管材及附件
70克伸性纸袋纸750	轻工、医药产品	纸及制品(十类)	机制纸（新闻纸）
70克纸袋纸787	轻工、医药产品	纸及制品(十类)	纸制品
双诚国际马来矿0719	机械设备、电器	电力设备、电器机械及器材	家用电器
70克涂布纸质纸787X1092	轻工、医药产品	纸及制品(十类)	机制纸（新闻纸）
80克伸性纸袋纸1200	轻工、医药产品	纸及制品(十类)	机制纸（新闻纸）
名称55克胶印书刊纸770	轻工、医药产品	工艺美术品	雕塑、刻、漆工艺品
60克轻型胶版纸889X1240	轻工、医药产品	纸及制品(十类)	机制纸（新闻纸）
75克伸性纸袋纸1000	轻工、医药产品	纸及制品(十类)	机制纸（新闻纸）
70克伸性纸袋纸1240	轻工、医药产品	纸及制品(十类)	机制纸（新闻纸）
80克纸袋纸920	轻工、医药产品	纸及制品(十类)	纸制品
60克纸袋纸790	轻工、医药产品	纸及制品(十类)	纸制品
方矩管 热镀管 热镀方矩管	钢铁	钢 材、合金钢材	管材及附件
58克轻型胶版纸865	轻工、医药产品	纸及制品(十类)	机制纸（新闻纸）
80克伸性纸袋纸820	轻工、医药产品	纸及制品(十类)	机制纸（新闻纸）
80克伸性纸袋纸770	轻工、医药产品	纸及制品(十类)	机制纸（新闻纸）
58克轻型胶版纸870	轻工、医药产品	纸及制品(十类)	机制纸（新闻纸）
65克轻型胶版纸850	轻工、医药产品	纸及制品(十类)	机制纸（新闻纸）
螺旋管+热镀	钢铁	钢 材、合金钢材	管材及附件
75克防锈原纸2430	轻工、医药产品	纸及制品(十类)	纸板（原纸）
70克纸袋纸920	轻工、医药产品	纸及制品(十类)	纸制品
58克热敏原纸1654	轻工、医药产品	纸及制品(十类)	其它纸及制品
95克纸袋纸1194	轻工、医药产品	纸及制品(十类)	纸制品
95克纸袋纸889	轻工、医药产品	纸及制品(十类)	纸制品
75克防锈原纸2830	轻工、医药产品	纸及制品(十类)	纸板（原纸）
775克防锈原纸1050	轻工、医药产品	纸及制品(十类)	纸板（原纸）
75克防锈原纸1050	轻工、医药产品	纸及制品(十类)	纸板（原纸）
75克防锈原纸1630	轻工、医药产品	纸及制品(十类)	纸板（原纸）
75克防锈原纸1540	轻工、医药产品	纸及制品(十类)	纸板（原纸）
75克防锈原纸2530	轻工、医药产品	纸及制品(十类)	纸板（原纸）
70克离型原纸1026深黄	轻工、医药产品	纸及制品(十类)	纸板（原纸）
圆管发辉县	钢铁	钢 材、合金钢材	管材及附件
轮胎架	钢铁	钢铁制品	其它
方管发成都	钢铁	钢 材、合金钢材	管材及附件
80克纸袋纸1098	轻工、医药产品	纸及制品(十类)	纸制品
镀锌焊管冀DQ5828	钢铁	钢 材、合金钢材	管材及附件
镀锌焊管冀DR3398	钢铁	钢 材、合金钢材	管材及附件
56克轻型胶版纸870	轻工、医药产品	纸及制品(十类)	机制纸（新闻纸）
75克轻型胶版纸700	轻工、医药产品	纸及制品(十类)	机制纸（新闻纸）
70克离型原纸1056	轻工、医药产品	纸及制品(十类)	纸板（原纸）
75克防锈原纸2270	轻工、医药产品	纸及制品(十类)	纸板（原纸）
75克防锈原纸1670	轻工、医药产品	纸及制品(十类)	纸板（原纸）
铁箱	钢铁	钢 材、合金钢材	钢铁件及其它五金制品
95克纸袋纸1020	轻工、医药产品	纸及制品(十类)	纸制品
95克纸袋纸1120	轻工、医药产品	纸及制品(十类)	纸制品
70克伸性纸袋纸830	轻工、医药产品	纸及制品(十类)	机制纸（新闻纸）
75克伸性纸袋纸690	轻工、医药产品	纸及制品(十类)	机制纸（新闻纸）
70克数码印刷纸390x2	轻工、医药产品	纸及制品(十类)	机制纸（新闻纸）
55克轻型胶版纸787x1092	轻工、医药产品	纸及制品(十类)	机制纸（新闻纸）
70克轻型胶版纸970	轻工、医药产品	纸及制品(十类)	机制纸（新闻纸）
67克离型原纸1055	轻工、医药产品	纸及制品(十类)	纸板（原纸）
83克轻型胶版纸889	轻工、医药产品	纸及制品(十类)	机制纸（新闻纸）
83克轻型胶版纸787	轻工、医药产品	纸及制品(十类)	机制纸（新闻纸）
67克离型原纸1250	轻工、医药产品	纸及制品(十类)	纸板（原纸）
60克胶印书刊纸394	轻工、医药产品	文化体育用品	印刷品
缆	化工原料及制品	针织、纺织、皮毛及制品	纱、线、丝、纤维（非复合材料）
75防锈原纸1670	轻工、医药产品	纸及制品(十类)	纸板（原纸）
75克防锈原纸2630	轻工、医药产品	纸及制品(十类)	纸板（原纸）
80克涂布纸纯质纸1092X787	轻工、医药产品	纸及制品(十类)	机制纸（新闻纸）
方矩管  热镀方矩管	钢铁	钢 材、合金钢材	管材及附件
85克伸性纸袋纸780	轻工、医药产品	纸及制品(十类)	机制纸（新闻纸）
石子	矿物性建筑材料	石料及石制品	其它
武汉65克轻型胶版纸765	轻工、医药产品	日用工业品	机制纸（新闻纸）
58克期刊杂志纸770	轻工、医药产品	饮食品	其它
67克离型原纸9500	轻工、医药产品	纸及制品(十类)	纸板（原纸）
68克轻型胶版纸850X1168	轻工、医药产品	纸及制品(十类)	机制纸（新闻纸）
68克轻型胶版纸960X650	轻工、医药产品	纸及制品(十类)	机制纸（新闻纸）
63克轻型胶版纸710X1000	轻工、医药产品	纸及制品(十类)	机制纸（新闻纸）
65克轻型胶版纸880X1230	轻工、医药产品	纸及制品(十类)	机制纸（新闻纸）
67克轻型胶版纸880X1230	轻工、医药产品	纸及制品(十类)	机制纸（新闻纸）
65克轻型胶版纸700X1000	轻工、医药产品	纸及制品(十类)	机制纸（新闻纸）
67克轻型胶版纸700X1000	轻工、医药产品	纸及制品(十类)	机制纸（新闻纸）
67克轻型胶版纸710X1000	轻工、医药产品	纸及制品(十类)	机制纸（新闻纸）
70克防锈原纸2030	轻工、医药产品	纸及制品(十类)	纸板（原纸）
55克胶印书刊纸787x1168	轻工、医药产品	文化体育用品	印刷品
68克高白胶板印刷纸770	轻工、医药产品	纸及制品(十类)	机制纸（新闻纸）
68克高白胶板印刷纸787	轻工、医药产品	纸及制品(十类)	机制纸（新闻纸）
68克高白胶板印刷纸889	轻工、医药产品	纸及制品(十类)	机制纸（新闻纸）
58克高白胶板印刷纸787	轻工、医药产品	纸及制品(十类)	机制纸（新闻纸）
80克典雅纯质纸890	轻工、医药产品	纸及制品(十类)	其它纸及制品
短绒	轻工、医药产品	针织、纺织、皮毛及制品	其它
n牛奶	轻工、医药产品	饮食品	乳制品，蜂蜜、王浆、粉
70克精品淋膜纸1055	轻工、医药产品	饮食品	其它工艺美术品
叶蜡石	非金属矿石	钢 材、合金钢材	管材及附件
140克精品牛皮889	轻工、医药产品	纸及制品(十类)	纸制品
100克精品牛皮787	轻工、医药产品	纸及制品(十类)	纸制品
68克离型原纸1250	轻工、医药产品	纸及制品(十类)	纸板（原纸）
70克纸袋纸1060	轻工、医药产品	纸及制品(十类)	纸制品
70克数码印刷纸400	轻工、医药产品	纸及制品(十类)	机制纸（新闻纸）
70克数码印刷纸400X2	轻工、医药产品	纸及制品(十类)	机制纸（新闻纸）
70克数码印刷纸520X2	轻工、医药产品	纸及制品(十类)	机制纸（新闻纸）
80克数码印刷纸4000X2	轻工、医药产品	纸及制品(十类)	机制纸（新闻纸）
80克数码数印刷纸400X2	轻工、医药产品	工艺美术品	其它工艺美术品
70克离型原纸深黄1026	轻工、医药产品	纸及制品(十类)	纸板（原纸）
75伸性纸袋纸1020	轻工、医药产品	纸及制品(十类)	机制纸（新闻纸）
75克伸性纸袋纸1010	轻工、医药产品	纸及制品(十类)	机制纸（新闻纸）
68克离型原纸1400	轻工、医药产品	纸及制品(十类)	纸板（原纸）
68克离型原纸945	轻工、医药产品	纸及制品(十类)	纸板（原纸）
方矩管+热镀+热镀方矩管	钢铁	钢 材、合金钢材	管材及附件
70克离型原纸1196	轻工、医药产品	纸及制品(十类)	纸板（原纸）
不等边角钢	钢铁	钢 材、合金钢材	板材
70克离型原纸深黄1096	轻工、医药产品	纸及制品(十类)	纸板（原纸）
120克离型原纸1255	轻工、医药产品	纸及制品(十类)	纸板（原纸）
热镀方钜管	钢铁	钢 材、合金钢材	管材及附件
95克轻型胶版纸889X1194	轻工、医药产品	纸及制品(十类)	机制纸（新闻纸）
95克轻型胶版纸787X1092	轻工、医药产品	纸及制品(十类)	机制纸（新闻纸）
锌精矿	金属矿石	铁矿石	其它
95克伸性纸袋纸1020	轻工、医药产品	纸及制品(十类)	机制纸（新闻纸）
啤酒饮料	轻工、医药产品	饮食品	饮料、果菜汁
75克防锈原纸1530	轻工、医药产品	纸及制品(十类)	纸板（原纸）
70克防锈原纸1430	轻工、医药产品	纸及制品(十类)	纸板（原纸）
齿轮	机械设备、电器	普通工业机械及设备	通用零部件
75克离型原纸1290	轻工、医药产品	纸及制品(十类)	纸板（原纸）
70克浆胶版纸770	轻工、医药产品	纸及制品(十类)	纸板（原纸）
68克胶印书刊纸870	轻工、医药产品	文化体育用品	印刷品
果冻奶茶	轻工、医药产品	饮食品	其它未列名饮食及调味食品
95克伸性纸袋纸1120	轻工、医药产品	纸及制品(十类)	机制纸（新闻纸）
80克伸性纸袋纸870	轻工、医药产品	纸及制品(十类)	机制纸（新闻纸）
115克精品年皮纸889	轻工、医药产品	纸及制品(十类)	机制纸（新闻纸）
140克粗品牛皮纸787	轻工、医药产品	饮食品	其它
70克防锈原纸1092	轻工、医药产品	纸及制品(十类)	纸板（原纸）
70无防锈原纸830	轻工、医药产品	纸及制品(十类)	纸制品
80克纸袋纸1350	轻工、医药产品	纸及制品(十类)	纸制品
70克纸袋纸1080	轻工、医药产品	纸及制品(十类)	纸制品
58克胶印书刊纸889	轻工、医药产品	文化体育用品	印刷品
67克克轻型胶版纸710x1000	轻工、医药产品	纸及制品(十类)	机制纸（新闻纸）
昌民  马来矿	农、林、牧、渔业产品	药材	烟叶、烟草、卷烟、雪茄及代用品
55克胶印书刊纸纸870	轻工、医药产品	文化体育用品	印刷品
55克胶印书刊纸787x1194	轻工、医药产品	文化体育用品	印刷品
60克胶印书刊纸445	轻工、医药产品	文化体育用品	印刷品
700克伸性纸袋纸1020	轻工、医药产品	纸及制品(十类)	机制纸（新闻纸）
物润马来矿1701009	其它货类	工艺美术品	其它
70克数码印刷纸440X2	轻工、医药产品	纸及制品(十类)	机制纸（新闻纸）
60克胶印书刊纸805X1140	轻工、医药产品	文化体育用品	印刷品
80克数码印刷纸400X2	轻工、医药产品	纸及制品(十类)	机制纸（新闻纸）
双胶纸5件	轻工、医药产品	纸及制品(十类)	纸板（原纸）
70点防锈原纸2270	轻工、医药产品	饮食品	雕塑、刻、漆工艺品
78克数码印刷纸390X2	轻工、医药产品	纸及制品(十类)	机制纸（新闻纸）
95克伸纸袋纸960	轻工、医药产品	纸及制品(十类)	机制纸（新闻纸）
80克胶印刷纸780	轻工、医药产品	纸及制品(十类)	机制纸（新闻纸）
昌民 马来矿	轻工、医药产品	纸及制品(十类)	其它
昌民2号    马来矿	轻工、医药产品	畜、禽、兽及制品	蛋类
70克离型原纸深黄1196	轻工、医药产品	纸及制品(十类)	纸板（原纸）
70克伸性纸袋纸710	轻工、医药产品	纸及制品(十类)	机制纸（新闻纸）
羊口盐	轻工、医药产品	饮食品	雕塑、刻、漆工艺品
冷轧基料卷SPHC-F	其它货类	钢 材、合金钢材	其它
籽	农、林、牧、渔业产品	铝	花草
70克离型原纸11198深黄	轻工、医药产品	纸及制品(十类)	纸板（原纸）
105克典雅纯质纸889	轻工、医药产品	纸及制品(十类)	其它纸及制品
105克典雅纯质纸787	轻工、医药产品	纸及制品(十类)	其它纸及制品
90克伸性纸袋纸770	轻工、医药产品	纸及制品(十类)	机制纸（新闻纸）
70克离型原纸240	轻工、医药产品	纸及制品(十类)	纸板（原纸）
65克轻型胶版纸100	轻工、医药产品	纸及制品(十类)	机制纸（新闻纸）
70克离型原纸1090	轻工、医药产品	纸及制品(十类)	纸板（原纸）
60克轻型胶版纸710	轻工、医药产品	纸及制品(十类)	机制纸（新闻纸）
60克轻型胶版纸1000	轻工、医药产品	纸及制品(十类)	机制纸（新闻纸）
100离型原纸1300	轻工、医药产品	纸及制品(十类)	纸板（原纸）
55克胶印书刊纸876	轻工、医药产品	文化体育用品	印刷品
昌民2/马来矿	轻工、医药产品	工艺美术品	合成橡胶
冷轧带钢	钢铁	钢铁制品	钢铁件及其它五金制品
方矩管%2b热镀方矩管	钢铁	钢 材、合金钢材	管材及附件
石材SSH	钢铁	钢 材、合金钢材	管材及附件
移动光缆	机械设备、电器	电子、电讯设备及器材	电子、光、磁、超声波装置的元器件、零件、附件
螺旋%2b热镀	钢铁	钢 材、合金钢材	管材及附件
焊%2b热镀管	钢铁	钢 材、合金钢材	管材及附件
热镀管%2b热镀方矩管	钢铁	钢 材、合金钢材	管材及附件
方%2b热镀	钢铁	钢 材、合金钢材	管材及附件
80克本色牛皮纸787	轻工、医药产品	纸及制品(十类)	鞋帽
70克本色牛皮纸787	轻工、医药产品	纸及制品(十类)	鞋帽
70克本色牛皮纸889	轻工、医药产品	纸及制品(十类)	鞋帽
100克本色牛皮纸787	轻工、医药产品	纸及制品(十类)	鞋帽
80克本色牛皮纸889	轻工、医药产品	纸及制品(十类)	鞋帽
6号机145克本色牛皮纸787	轻工、医药产品	日用工业品	家具、坐具
6号机100克本色牛皮纸889	轻工、医药产品	日用工业品	家具、坐具
6号机120克本色牛皮纸787	轻工、医药产品	日用工业品	家具、坐具
6号机145克本色牛皮纸889	轻工、医药产品	日用工业品	家具、坐具
6号机100克本色牛皮纸787	轻工、医药产品	日用工业品	家具、坐具
9号机68克轻型胶版纸870	轻工、医药产品	日用工业品	家具、坐具
1号机60克胶印书刊纸787	轻工、医药产品	饮食品	其它未列名饮食及调味食品
3号机73克离型原纸1233	轻工、医药产品	日用工业品	家具、坐具
3号机73克离型原纸1053	轻工、医药产品	日用工业品	家具、坐具
3号机67克离型原纸1300	轻工、医药产品	日用工业品	家具、坐具
3号机67克离型原纸945	轻工、医药产品	日用工业品	家具、坐具
3号机67克离型原纸1100	轻工、医药产品	日用工业品	家具、坐具
3号机67克离型原纸1550	轻工、医药产品	日用工业品	家具、坐具
3号机73克离型原纸1183	轻工、医药产品	日用工业品	家具、坐具
科斯马来矿	轻工、医药产品	工艺美术品	其它
热镀方矩管%2b方矩管	钢铁	钢 材、合金钢材	管材及附件
昌民2号 马来矿	轻工、医药产品	畜、禽、兽及制品	蛋类
热镀%2b螺旋	钢铁	钢 材、合金钢材	管材及附件
热镀%2b热镀方矩管	钢铁	钢 材、合金钢材	管材及附件
9米螺纹钢	钢铁	钢 材、合金钢材	线材
镍板	钢铁	钢 材、合金钢材	板材
%2b热镀管	钢铁	钢 材、合金钢材	管材及附件
60克胶印书刊纸700960	轻工、医药产品	文化体育用品	印刷品
70克轻型胶版纸7001000	轻工、医药产品	纸及制品(十类)	机制纸（新闻纸）
55克期刊杂志纸870	轻工、医药产品	饮食品	其它
70克轻型胶版纸8801230	轻工、医药产品	纸及制品(十类)	机制纸（新闻纸）
热镀方矩管加方矩管	钢铁	钢 材、合金钢材	管材及附件
热镀%2b黑方	钢铁	钢 材、合金钢材	管材及附件
65克离型原纸1170	轻工、医药产品	纸及制品(十类)	纸板（原纸）
l螺纹	钢铁	钢 材、合金钢材	线材
115克本色牛皮纸787	轻工、医药产品	纸及制品(十类)	鞋帽
55克胶印书刊纸8891194	轻工、医药产品	文化体育用品	印刷品
科斯2号马来矿	轻工、医药产品	饮食品	布匹（机织、绒织、网织物、纱罗）
90克伸性纸袋纸1055	轻工、医药产品	纸及制品(十类)	机制纸（新闻纸）
68克轻型胶版纸980710	轻工、医药产品	纸及制品(十类)	机制纸（新闻纸）
HRR直条螺纹钢汽运看清楚要求	钢铁	钢 材、合金钢材	线材
68克轻型胶版纸640	轻工、医药产品	纸及制品(十类)	机制纸（新闻纸）
70克轻胶版纸690980980690	轻工、医药产品	纸及制品(十类)	机制纸（新闻纸）
科斯2/马来矿	轻工、医药产品	工艺美术品	其它
海信冰箱	机械设备、电器	电力设备、电器机械及器材	家用电器
热镀管%2b螺旋管	钢铁	钢 材、合金钢材	管材及附件
HTP汽车运输请看清楚要求	机械设备、电器	交通运输设备	计量器具
80伸性纸袋纸780	轻工、医药产品	纸及制品(十类)	机制纸（新闻纸）
70克轻型胶版纸730	轻工、医药产品	纸及制品(十类)	机制纸（新闻纸）
热镀管热镀方矩管方矩管	钢铁	钢 材、合金钢材	管材及附件
热镀%2b方	钢铁	钢 材、合金钢材	管材及附件
68克轻型胶版纸970	轻工、医药产品	纸及制品(十类)	机制纸（新闻纸）
68克胶印书刊纸880	轻工、医药产品	文化体育用品	印刷品
68克轻型胶版纸730	轻工、医药产品	纸及制品(十类)	机制纸（新闻纸）
68克离型原纸深黄1035	轻工、医药产品	纸及制品(十类)	纸板（原纸）
68克离型原纸1026深黄	轻工、医药产品	纸及制品(十类)	纸板（原纸）
科斯2 马来矿	轻工、医药产品	纸及制品(十类)	布匹（机织、绒织、网织物、纱罗）
68克离型原纸1035深黄	轻工、医药产品	纸及制品(十类)	纸板（原纸）
减震器齿轮	机械设备、电器	普通工业机械及设备	通用设备
热镀管%2b方矩管	钢铁	钢 材、合金钢材	管材及附件
科斯/马来矿	轻工、医药产品	工艺美术品	其它
科斯2# 马来矿	轻工、医药产品	纸及制品(十类)	布匹（机织、绒织、网织物、纱罗）
鹅卵石	轻工、医药产品	工艺美术品	雕塑、刻、漆工艺品
热镀%2b热方	钢铁	钢 材、合金钢材	管材及附件
科斯1# 马来矿	轻工、医药产品	纸及制品(十类)	布匹（机织、绒织、网织物、纱罗）
科斯1 马来矿	轻工、医药产品	纸及制品(十类)	布匹（机织、绒织、网织物、纱罗）
绿叶	轻工、医药产品	饮食品	普通金属工艺品
绿叶相思浆	轻工、医药产品	工艺美术品	纸浆
热镀方矩管%2b热镀管	钢铁	钢 材、合金钢材	管材及附件
热镀管方矩管热镀方矩管	钢铁	钢 材、合金钢材	管材及附件
67克离型原纸946	轻工、医药产品	纸及制品(十类)	纸板（原纸）
67克离型原纸1297	轻工、医药产品	纸及制品(十类)	纸板（原纸）
配电箱	机械设备、电器	电子、电讯设备及器材	电子、光、磁、超声波装置的元器件、零件、附件
镀铬卷	钢铁	钢 材、合金钢材	卷材
卷-纸	其它货类	纸及制品(十类)	其它
黑方加热方发南昌	钢铁	钢 材、合金钢材	管材及附件
12x9米钢筋	钢铁	钢 材、合金钢材	线材
三叶草/澳块	钢铁	钢 材、合金钢材	管材及附件
羊口博汇盐	钢铁	钢铁制品	管材及附件
三叶草93A澳块	钢铁	钢 材、合金钢材	管材及附件
螺旋管%2b热镀管	钢铁	钢 材、合金钢材	管材及附件
日照螺纹钢连云港	钢铁	钢 材、合金钢材	管材及附件
马牌浆	轻工、医药产品	纸及制品(十类)	其它
回镀管热镀方管区	钢铁	钢 材、合金钢材	管材及附件
和风2 马来矿	轻工、医药产品	针织、纺织、皮毛及制品	布匹（机织、绒织、网织物、纱罗）
热镀管%2b方矩管%2b热镀方矩管	钢铁	钢 材、合金钢材	管材及附件
方矩管%2b热镀管	钢铁	钢 材、合金钢材	管材及附件
和风2# 马来矿	轻工、医药产品	针织、纺织、皮毛及制品	布匹（机织、绒织、网织物、纱罗）
胶水lma	轻工、医药产品	日用工业品	其它日用品
热镀方矩管热镀管热镀管	钢铁	钢 材、合金钢材	管材及附件
热镀方法长葛	钢铁	钢 材、合金钢材	管材及附件
热镀管燃气管	钢铁	钢 材、合金钢材	管材及附件
热镀管燃气	钢铁	钢 材、合金钢材	管材及附件
王牌冰箱。	机械设备、电器	电力设备、电器机械及器材	家用电器
美菱冰箱。	机械设备、电器	电力设备、电器机械及器材	家用电器
圆钢管	钢铁	钢 材、合金钢材	线材
热镀管%2b热镀	钢铁	钢 材、合金钢材	管材及附件
HRR直条螺纹钢	钢铁	钢 材、合金钢材	线材
热轧%2b正火热处理汽运	钢铁	钢 材、合金钢材	钢铁件及其它五金制品
低温螺纹钢汽运	钢铁	钢 材、合金钢材	线材
王牌冰箱	机械设备、电器	电力设备、电器机械及器材	家用电器
容声洗衣机	机械设备、电器	电力设备、电器机械及器材	家用电器
3号机65克离型原纸945	轻工、医药产品	日用工业品	家具、坐具
成品小裁-70克复印纸210×297	轻工、医药产品	纸及制品(十类)	其它
马克B煤	煤炭及制品	原煤	无烟煤
热镀方矩管%2b方矩管%2b热镀管	钢铁	钢 材、合金钢材	管材及附件
镀锌焊管冀DQ9122	钢铁	钢 材、合金钢材	管材及附件
镀锌焊管冀DN2453	钢铁	钢 材、合金钢材	管材及附件
镀锌焊管冀DW5899	钢铁	钢 材、合金钢材	管材及附件
卷筒纸GYG	轻工、医药产品	纸及制品(十类)	乳制品，蜂蜜、王浆、粉
卷纸PHJ	其它货类	纸及制品(十类)	其它
石材PHJ	钢铁	钢 材、合金钢材	管材及附件
王牌洗衣机	机械设备、电器	电力设备、电器机械及器材	家用电器
镀锌焊管冀DN8170	钢铁	钢 材、合金钢材	管材及附件
镀锌焊管冀DS7809	钢铁	钢 材、合金钢材	管材及附件
星星冷柜	机械设备、电器	电力设备、电器机械及器材	金属加工机械及设备
和风1/马来矿	轻工、医药产品	纸及制品(十类)	其它
豆粕PHJ	粮食	杂粮	杂豆
酒LMA	轻工、医药产品	饮食品	酒（白酒、啤酒、果酒类）
牛奶LMA	轻工、医药产品	饮食品	乳制品，蜂蜜、王浆、粉
HRR直条螺纹钢汽运	钢铁	钢 材、合金钢材	线材
袋装合金和钢板汽运请看清楚要求	钢铁	钢铁制品	其它
80克胶印印刷纸870	轻工、医药产品	纸及制品(十类)	机制纸（新闻纸）
承力索	机械设备、电器	电力设备、电器机械及器材	电工器材
脚手架	机械设备、电器	电力设备、电器机械及器材	家用电器
纸浆XLH	轻工、医药产品	纸及制品(十类)	纸浆
油包LMA	轻工、医药产品	日用工业品	钢铁容器
纸浆PHJ	轻工、医药产品	纸及制品(十类)	纸浆
纸浆SJ	轻工、医药产品	纸及制品(十类)	纸浆
镀锌焊管冀DQ6971	钢铁	钢 材、合金钢材	管材及附件
鑫成马来矿0701	轻工、医药产品	饮食品	其它纸及制品
星星冰柜	机械设备、电器	电力设备、电器机械及器材	家用电器
螺纹钢22×12	钢铁	钢 材、合金钢材	线材
螺纹钢20×12	钢铁	钢 材、合金钢材	线材
14×12螺纹钢	钢铁	钢 材、合金钢材	线材
20×12螺纹钢	钢铁	钢 材、合金钢材	线材
14×12米螺纹	钢铁	钢 材、合金钢材	钢铁件及其它五金制品
20×12米螺纹	钢铁	钢 材、合金钢材	钢铁件及其它五金制品
油菜饼	轻工、医药产品	饮食品	经济作物原料、残渣及副产品
和风1#马来矿	轻工、医药产品	纸及制品(十类)	其它
天然烟片橡胶	化工原料及制品	橡胶	天然橡胶
分解机热镀方矩管	机械设备、电器	专用机械、设备及制品	道路机动车辆
桥面板	钢铁	钢铁制品	钢铁材料、结构体
成品小裁70复印纸	轻工、医药产品	纸及制品(十类)	其它
锅炉	轻工、医药产品	针织、纺织、皮毛及制品	其它
60克胶印书刊纸8701295	轻工、医药产品	文化体育用品	印刷品
螺纹钢陕工建	钢铁	钢 材、合金钢材	线材
60克胶印书刊纸8701100	轻工、医药产品	文化体育用品	印刷品
热镀方矩%2b热镀管	钢铁	钢 材、合金钢材	管材及附件
60克胶印书刊纸8701200	轻工、医药产品	文化体育用品	印刷品
80克胶印书刊纸7181000	轻工、医药产品	文化体育用品	印刷品
螺纹钢22×2	钢铁	钢 材、合金钢材	线材
黄骅大载铁矿粉	农、林、牧、渔业产品	竹、木、藤、花、草	道路机动车辆
迁安热镀光管	钢铁	钢铁制品	管材及附件
螺纹钢 25×12	钢铁	钢 材、合金钢材	线材
115克染色原纸787	轻工、医药产品	纸及制品(十类)	纸板（原纸）
镀锌焊管冀DQ9335	钢铁	钢 材、合金钢材	管材及附件
60克胶印书刊纸8301295	轻工、医药产品	文化体育用品	印刷品
80克胶印印刷纸	轻工、医药产品	纸及制品(十类)	机制纸（新闻纸）
食品添加剂LLL	化工原料及制品	其它未列名化工原料及制品	其它
智	轻工、医药产品	文化体育用品	文教办公用品
螺纹钢28×12米	钢铁	钢 材、合金钢材	线材
螺纹钢25×12米	钢铁	钢 材、合金钢材	线材
螺纹钢32×12米	钢铁	钢 材、合金钢材	线材
螺纹钢22×12米	钢铁	钢 材、合金钢材	线材
60克胶印胶版纸770	轻工、医药产品	纸及制品(十类)	机制纸（新闻纸）
60克胶印书刊纸8051104	轻工、医药产品	文化体育用品	印刷品
成品小裁70克复印纸	轻工、医药产品	纸及制品(十类)	其它
纸箱PHJ	轻工、医药产品	纸及制品(十类)	纺织材料包、套等，复合材料纱、线、绳
14X12螺纹	钢铁	钢 材、合金钢材	线材
16X12螺纹	钢铁	钢 材、合金钢材	线材
螺纹钢12×1	钢铁	钢 材、合金钢材	线材
螺纹钢18×12米	钢铁	钢 材、合金钢材	线材
螺纹32X12米	钢铁	钢 材、合金钢材	线材
16×12螺纹钢	钢铁	钢 材、合金钢材	线材
28×12螺纹钢	钢铁	钢 材、合金钢材	线材
螺纹32X12	钢铁	钢 材、合金钢材	线材
12×12螺纹钢	钢铁	钢 材、合金钢材	线材
伊利牛奶	轻工、医药产品	饮食品	乳制品，蜂蜜、王浆、粉
牛奶261219	轻工、医药产品	饮食品	乳制品，蜂蜜、王浆、粉
70克伸性纸袋纸	轻工、医药产品	纸及制品(十类)	机制纸（新闻纸）
牛奶261345	轻工、医药产品	饮食品	乳制品，蜂蜜、王浆、粉
牛奶261349	轻工、医药产品	饮食品	乳制品，蜂蜜、王浆、粉
必填70克胶版印书刊纸	轻工、医药产品	纸及制品(十类)	其它纸及制品
140克胶印书刊纸	轻工、医药产品	文化体育用品	印刷品
牛奶261651	轻工、医药产品	饮食品	乳制品，蜂蜜、王浆、粉
80克伸性纸袋纸	轻工、医药产品	纸及制品(十类)	机制纸（新闻纸）
牛奶262068	轻工、医药产品	饮食品	乳制品，蜂蜜、王浆、粉
70克胶印复印纸	轻工、医药产品	纸及制品(十类)	纺织材料絮胎及制品、短纤维屑、粉
牛奶262234	轻工、医药产品	饮食品	乳制品，蜂蜜、王浆、粉
工字钢%2b槽钢杨山	钢铁	钢 材、合金钢材	型材
牛奶262586	轻工、医药产品	饮食品	乳制品，蜂蜜、王浆、粉
牛奶262585	轻工、医药产品	饮食品	乳制品，蜂蜜、王浆、粉
牛奶262658	轻工、医药产品	饮食品	乳制品，蜂蜜、王浆、粉
麦格尼飞纸箱	轻工、医药产品	其它未列名化工原料及制品	其它
麦格尼飞机油	轻工、医药产品	其它未列名化工原料及制品	其它
连铸坯水陆联运	钢铁	钢 材、合金钢材	线材
牛奶263586	轻工、医药产品	饮食品	乳制品，蜂蜜、王浆、粉
盘扣式脚手架	金属矿石	铁矿石	其它
工字钢%2b槽钢	钢铁	钢 材、合金钢材	型材
槽钢%2b工字钢	钢铁	钢 材、合金钢材	型材
25×12螺纹钢	钢铁	钢 材、合金钢材	线材
牛奶263810	轻工、医药产品	饮食品	乳制品，蜂蜜、王浆、粉
牛奶263767	轻工、医药产品	饮食品	乳制品，蜂蜜、王浆、粉
面奶SCY	轻工、医药产品	饮食品	乳制品，蜂蜜、王浆、粉
64K克制轻量涂布纸	轻工、医药产品	纸及制品(十类)	纸制品
正大热镀	钢铁	钢 材、合金钢材	管材及附件
槽角钢	钢铁	钢 材、合金钢材	型材
12×14螺纹钢	钢铁	钢 材、合金钢材	线材
12×16螺纹钢	钢铁	钢 材、合金钢材	线材
50克期刊杂志纸	轻工、医药产品	饮食品	其它
钢筋LYX	钢铁	钢 材、合金钢材	线材
日用品LYX	轻工、医药产品	日用工业品	卫生品(洗涤剂、皂类)
螺纹28X12米	钢铁	钢 材、合金钢材	线材
热轧带钢卷	钢铁	钢铁制品	钢铁件及其它五金制品
钢材型材冰	钢铁	钢 材、合金钢材	管材及附件
板皮	钢铁	钢 材、合金钢材	板材
钢材诚鑫	钢铁	钢铁制品	线材
500g省外版软包装盐	轻工、医药产品	纸及制品(十类)	针织、纺织制品
500g淮盐牌精制食用盐非绿标省外	盐	加工盐	其它
400g淮盐牌精制食用盐500g淮盐牌精制食用盐	盐	加工盐	其它
湿纸浆	轻工、医药产品	纸及制品(十类)	机制纸（新闻纸）
平山敬业青岛董家口铁矿粉	金属矿石	铁矿石	其它
圆钢汽运4家客户的货	钢铁	钢 材、合金钢材	线材
平山敬业青岛前湾港铁矿粉	金属矿石	铁矿石	其它
圆钢中心库到大厂库	钢铁	钢 材、合金钢材	线材
三叶草澳块	钢铁	钢 材、合金钢材	管材及附件
溶剂油江河	钢铁	钢铁制品	钢铁件及其它五金制品
热压铁块	钢铁	钢 材、合金钢材	板材
槽	钢铁	钢 材、合金钢材	型材
螺纹 钢	钢铁	钢 材、合金钢材	线材
德胜海马来矿	金属矿石	钢 材、合金钢材	线材
博兴兴福站铁矿粉	轻工、医药产品	纸及制品(十类)	其它
黄骅大载精粉铁矿粉	农、林、牧、渔业产品	竹、木、藤、花、草	道路机动车辆
螺纹，	钢铁	钢 材、合金钢材	线材
18×12螺纹钢	钢铁	钢 材、合金钢材	线材
螺纹钢12×9	钢铁	钢 材、合金钢材	线材
螺纹钢20×9	钢铁	钢 材、合金钢材	线材
得信邦合川末煤	轻工、医药产品	针织、纺织、皮毛及制品	针织、纺织制品
天津大载铁矿粉	金属矿石	钢 材、合金钢材	其它
纸袋纸	轻工、医药产品	纸及制品(十类)	纸制品
黄骅标载铁矿粉	机械设备、电器	钢 材、合金钢材	道路机动车辆
优沫煤	煤炭及制品	原煤	烟煤
伸性纸袋纸	轻工、医药产品	纸及制品(十类)	机制纸（新闻纸）
60克高白胶板印刷纸	轻工、医药产品	纸及制品(十类)	机制纸（新闻纸）
曹妃甸港铁矿粉	轻工、医药产品	日用工业品	其它
水性涂料	轻工、医药产品	其它	其它
65克高白胶板印刷纸	轻工、医药产品	纸及制品(十类)	机制纸（新闻纸）
无烟沫煤	煤炭及制品	钢铁制品	其它
德胜海   马来矿	钢铁	钢 材、合金钢材	钢铁件及其它五金制品
德晟马克焦煤(A1煤)	金属矿石	铁矿石	其它
钢管LYX	钢铁	钢 材、合金钢材	管材及附件
凉水井煤	矿物性建筑材料	钢铁制品	其它
煤	煤炭及制品	原煤	无烟煤
大载铁矿粉	金属矿石	铁矿石	其它
标载铁矿粉	金属矿石	铁矿石	其它
钢轨圆钢	钢铁	钢 材、合金钢材	线材
油烟机	机械设备、电器	仪器仪表、计量器具、工具	锅炉、发动机 动力装置及辅助设备
热方加热带35T发嘉鱼	钢铁	钢 材、合金钢材	管材及附件
中文汇通金布巴粉	钢铁	钢 材、合金钢材	管材及附件
支架	钢铁	钢铁制品	钢铁件及其它五金制品
钢卷板电话联系13390929822	钢铁	钢 材、合金钢材	板材
天津锦亿铁矿粉0508	其它货类	工艺美术品	其它
Q345R%2b不锈钢复合板船运从安徽汊河拖回南钢装船	钢铁	钢 材、合金钢材	卷材
钢材冷板	钢铁	钢 材、合金钢材	卷材
牛奶274367	轻工、医药产品	饮食品	乳制品，蜂蜜、王浆、粉
钢筋95298	钢铁	钢 材、合金钢材	线材
350g淮牌精致食用盐	机械设备、电器	钢 材、合金钢材	道路机动车辆
铝卷铝板	有色金属	铝	精铝及铝材
白油	轻工、医药产品	经济作物及制品	动植物食用油料、脂肪及制品
数控铣床	轻工、医药产品	日用工业品	其它
海绵	有色金属	其它	其它
甲苯	轻工、医药产品	针织、纺织、皮毛及制品	其它
松香	化工原料及制品	其它	其它未列名饮食及调味食品
更多	轻工、医药产品	针织、纺织、皮毛及制品	其它
无机颜料	轻工、医药产品	日用化工品	卫生品(洗涤剂、皂类)
地坪漆	轻工、医药产品	其它未列名化工原料及制品	刺绣编织工艺品、地毯
生物化工	轻工、医药产品	饮食品	机制纸（新闻纸）
氮肥	轻工、医药产品	工艺美术品	雕塑、刻、漆工艺品
热熔胶	钢铁	钢铁制品	其它
橡塑	钢铁	钢铁制品	钢铁件及其它五金制品
通用塑料	机械设备、电器	电子、电讯设备及器材	电子、光、磁、超声波装置的元器件、零件、附件
工程塑料	轻工、医药产品	工艺美术品	橡胶制品
PVC	轻工、医药产品	竹、木、藤、花、草	陶瓷制品
化工废料	其它货类	日用化工品	普通金属工艺品
再生塑料	轻工、医药产品	日用化工品	其它
塑料片	化工原料及制品	其它	其它
塑料加工	钢铁	钢铁制品	其它
波纹管	钢铁	钢 材、合金钢材	管材及附件
塑料薄膜	化工原料及制品	其它未列名轻工产品	其它
混合机	机械设备、电器	普通工业机械及设备	重工业机械、工程机械及零件
干燥机	轻工、医药产品	饮食品	饮料、果菜汁
空压机	机械设备、电器	电力设备、电器机械及器材	家用电器
涂装设备	钢铁	钢 材、合金钢材	卷材
绞肉机	农、林、牧、渔业产品	竹、木、藤、花、草	竹
绣花机	机械设备、电器	专用机械、设备及制品	重工业机械、工程机械及零件
缝纫机	轻工、医药产品	针织、纺织、皮毛及制品	卫生品(洗涤剂、皂类)
裁断机	机械设备、电器	专用机械、设备及制品	重工业机械、工程机械及零件
吸塑机	机械设备、电器	专用机械、设备及制品	重工业机械、工程机械及零件
封口机	机械设备、电器	专用机械、设备及制品	制冷、加热、燃烧设备
喷码机	机械设备、电器	专用机械、设备及制品	重工业机械、工程机械及零件
起重机	机械设备、电器	交通运输设备	通用设备
机加工	矿物性建筑材料	其它	其它
磨加工	化工原料及制品	其它	其它
锁具	轻工、医药产品	文化体育用品	文教办公用品
望远镜	轻工、医药产品	针织、纺织、皮毛及制品	服装
电子称	机械设备、电器	其它	其它
温度计	化工原料及制品	工艺美术品	其它
温控器	机械设备、电器	普通工业机械及设备	金属加工机械及设备
流量计	机械设备、电器	专用机械、设备及制品	道路机动车辆
固定电话	机械设备、电器	普通工业机械及设备	制冷、加热、燃烧设备
车身附件	机械设备、电器	专用机械、设备及制品	其它
升降机	机械设备、电器	专用机械、设备及制品	重工业机械、工程机械及零件
护手霜	机械设备、电器	日用化工品	电工器材
窗帘	轻工、医药产品	针织、纺织、皮毛及制品	鞋帽
坐垫	轻工、医药产品	日用工业品	家具、坐具
雪地靴	轻工、医药产品	日用工业品	家具、坐具
客厅茶几	轻工、医药产品	经济作物及制品	畜、禽、兽肉及制品
吧台	轻工、医药产品	日用工业品	其它日用品
火锅	轻工、医药产品	针织、纺织、皮毛及制品	布匹（机织、绒织、网织物、纱罗）
压力锅	机械设备、电器	电力设备、电器机械及器材	输变电设备
护栏板立柱小件	钢铁	钢铁制品	钢铁材料、结构体
护栏板立柱	钢铁	钢铁制品	钢铁材料、结构体
普板立柱	钢铁	钢 材、合金钢材	钢铁材料、结构体
板柱小件	钢铁	钢铁制品	钢铁材料、结构体
护栏板立柱端头	钢铁	钢铁制品	钢铁材料、结构体
护栏板小件	钢铁	钢铁制品	钢铁材料、结构体
板柱	钢铁	钢铁制品	条、杆、角、网、栅、丝材
护栏板焊接立柱	钢铁	钢铁制品	钢铁材料、结构体
护栏板法兰立柱	钢铁	钢铁制品	钢铁材料、结构体
护栏板立柱等	钢铁	钢铁制品	钢铁材料、结构体
护栏板端头	钢铁	钢铁制品	钢铁材料、结构体
立柱小件护栏板	钢铁	钢铁制品	钢铁材料、结构体
桨板	轻工、医药产品	纸及制品(十类)	纱、线、丝、纤维（非复合材料）
护栏加强板	钢铁	钢铁制品	钢铁件及其它五金制品
地桩管立柱螺栓	钢铁	钢铁制品	钢铁材料、结构体
板端头	轻工、医药产品	钢 材、合金钢材	其它
钢铁	钢铁	生铁、铁合金、非合金钢	板材
扣板	钢铁	钢 材、合金钢材	板材
陶板	轻工、医药产品	专用机械、设备及制品	其它电器设备
焊丝	钢铁	钢铁制品	钢铁材料、结构体
电焊条	钢铁	钢 材、合金钢材	钢铁件及其它五金制品
立柱	钢铁	钢铁制品	钢铁材料、结构体
喷塑护栏板护栏板	钢铁	钢铁制品	管材及附件
立柱板	钢铁	钢铁制品	钢铁材料、结构体
喷塑护栏板	钢铁	钢铁制品	管材及附件
护栏材料喷塑护栏板	钢铁	钢 材、合金钢材	管材及附件
喷塑护栏板制品	钢铁	钢铁制品	管材及附件
浸塑护栏板	钢铁	钢铁制品	管材及附件
绝缘板	钢铁	钢 材、合金钢材	板材
低热值煤	钢铁	钢 材、合金钢材	铁或非合金钢板轧材、卷、角、型材
夹芯板	钢铁	钢 材、合金钢材	板材
底板	钢铁	钢 材、合金钢材	板材
80本白胶卷880	轻工、医药产品	纸及制品(十类)	机制纸（新闻纸）
车板	钢铁	钢 材、合金钢材	板材
胶版平板	轻工、医药产品	纸及制品(十类)	机制纸（新闻纸）
PP拉丝级	钢铁	钢 材、合金钢材	线材
发随州装带钢	钢铁	钢 材、合金钢材	管材及附件
发随州带钢	钢铁	钢 材、合金钢材	钢铁件及其它五金制品
IP平板桨	轻工、医药产品	纸及制品(十类)	鞋帽
随州市鸿源发随州装带钢30吨左右	钢铁	钢 材、合金钢材	管材及附件
随州市鸿源装带钢30吨左右	钢铁	钢 材、合金钢材	管材及附件
随州带钢小车	钢铁	钢铁制品	钢铁件及其它五金制品
包带发迁安	化工原料及制品	纸及制品(十类)	其它
光伏并网逆变器	钢铁	钢铁制品	钢铁件及其它五金制品
垫杠包带	轻工、医药产品	纸及制品(十类)	纸板（原纸）
迁安正大一车包带发迁安	钢铁	钢铁制品	管材及附件
行李架	钢铁	钢铁制品	钢铁件及其它五金制品
包带或者垫杠	化工原料及制品	纸及制品(十类)	其它
喷吹煤	煤炭及制品	原煤	烟煤
带铁	钢铁	钢铁制品	钢铁件及其它五金制品
扰流板	机械设备、电器	交通运输设备	其它运输辅件及器材
喷吹煤l	煤炭及制品	原煤	烟煤
棒材汽运包车精品运输	钢铁	钢 材、合金钢材	带材
角	钢铁	钢 材、合金钢材	型材
橡胶衬板	化工原料及制品	工艺美术品	雕塑、刻、漆工艺品
光伏逆变器	机械设备、电器	电子、电讯设备及器材	电子、光、磁、超声波装置的元器件、零件、附件
逆变器	机械设备、电器	电力设备、电器机械及器材	输变电设备
沙	轻工、医药产品	日用工业品	家具、坐具
钢板料	钢铁	钢 材、合金钢材	板材
李帅带钢	钢铁	钢铁制品	钢铁件及其它五金制品
合信带钢	钢铁	钢铁制品	钢铁件及其它五金制品
金通丰带钢	钢铁	钢铁制品	钢铁件及其它五金制品
铸峰带钢	钢铁	钢铁制品	钢铁件及其它五金制品
奥科达带钢	轻工、医药产品	纸及制品(十类)	纺织材料包、套等，复合材料纱、线、绳
天虹带钢	钢铁	钢铁制品	钢铁件及其它五金制品
盛泰带钢	钢铁	钢铁制品	钢铁件及其它五金制品
新武安文安带钢	钢铁	钢 材、合金钢材	管材及附件
四通带钢	钢铁	钢铁制品	钢铁件及其它五金制品
刘万利带钢	轻工、医药产品	各种废旧物品	印刷品
文安带钢	钢铁	钢铁制品	管材及附件
正大文安带钢355	轻工、医药产品	纸及制品(十类)	纸浆
正大文安带钢352	轻工、医药产品	纸及制品(十类)	纸浆
正大文安带钢272	轻工、医药产品	纸及制品(十类)	纸浆
正大带钢352	钢铁	钢铁制品	钢铁件及其它五金制品
正大奥森带钢432	钢铁	钢铁制品	其它
正大文安带钢232	轻工、医药产品	纸及制品(十类)	纸浆
活动板房	钢铁	钢 材、合金钢材	板材
原板	钢铁	钢 材、合金钢材	板材
挂板	钢铁	钢 材、合金钢材	板材
箱板纸	轻工、医药产品	纸及制品(十类)	纸板（原纸）
奥东煤炭	轻工、医药产品	其它未列名化工原料及制品	雕塑、刻、漆工艺品
安县煤炭	钢铁	钢铁制品	其它
北川煤炭	轻工、医药产品	杂粮	机制纸（新闻纸）
资阳煤炭	钢铁	钢铁制品	其它
澳东煤炭	轻工、医药产品	工艺美术品	雕塑、刻、漆工艺品
砂加气板	钢铁	钢 材、合金钢材	板材
保温棉	化工原料及制品	其它未列名化工原料及制品	其它
密封制品	轻工、医药产品	饮食品	罐头，硬、软包装食品
玻璃	轻工、医药产品	日用工业品	玻璃制品
土工格栅	轻工、医药产品	纸及制品(十类)	纸浆
防水材料	其它货类	其它未列名矿建材料	其它
炉料	轻工、医药产品	针织、纺织、皮毛及制品	其它
板材卷材	钢铁	钢 材、合金钢材	卷材
盆景	轻工、医药产品	针织、纺织、皮毛及制品	其它
生核桃	轻工、医药产品	针织、纺织、皮毛及制品	服装
叶菜类	轻工、医药产品	畜、禽、兽及制品	经济作物原料、残渣及副产品
太阳能	机械设备、电器	电子、电讯设备及器材	电子、光、磁、超声波装置的元器件、零件、附件
刀具夹具	轻工、医药产品	日用工业品	其它日用品
密封	轻工、医药产品	针织、纺织、皮毛及制品	其它
加工	其它货类	其它	其它
镀锌	钢铁	钢 材、合金钢材	管材及附件
地板蜡	机械设备、电器	普通工业机械及设备	制冷、加热、燃烧设备
模型	机械设备、电器	普通工业机械及设备	家用电器
奶嘴	轻工、医药产品	文化体育用品	乳制品，蜂蜜、王浆、粉
抱带	其它货类	塑料及制品	其它
门	钢铁	钢铁制品	钢铁容器
窗	轻工、医药产品	文化体育用品	服装
拉链	钢铁	钢铁制品	钢铁件及其它五金制品
酒店行李柜	轻工、医药产品	日用工业品	家具、坐具
背带抱带	化工原料及制品	塑料及制品	其它
柜机	轻工、医药产品	日用工业品	家具、坐具
机	机械设备、电器	其它	其它
报刊架	钢铁	钢铁制品	线材
色带碳带	其它货类	其它	其它
手机座手机架	轻工、医药产品	日用工业品	家具、坐具
皮带	轻工、医药产品	塑料及制品	其它
餐具套	轻工、医药产品	日用工业品	其它日用品
杯垫餐具垫	轻工、医药产品	日用工业品	家具、坐具
魔方	钢铁	钢 材、合金钢材	管材及附件
储蓄罐	轻工、医药产品	文化体育用品	树木
冰箱贴	机械设备、电器	电力设备、电器机械及器材	家用电器
U盘	钢铁	钢 材、合金钢材	钢铁容器
香炉	化工原料及制品	日用化工品	卫生品(洗涤剂、皂类)
玻璃工艺品玻璃摆件	轻工、医药产品	日用工业品	纸浆
水晶工艺品水晶礼品定制	轻工、医药产品	饮食品	其它未列名饮食及调味食品
置物架	钢铁	钢铁制品	钢铁件及其它五金制品
肉罐头	轻工、医药产品	饮食品	雕塑、刻、漆工艺品
压型钢板及收边板	钢铁	钢 材、合金钢材	板材
板法兰柱小件	钢铁	钢铁制品	铁或非合金钢板轧材、卷、角、型材
玩具	轻工、医药产品	文化体育用品	文教办公用品
焊热螺旋	钢铁	钢 材、合金钢材	管材及附件
镀锌带	钢铁	钢铁制品	钢铁件及其它五金制品
酒+矿泉水	轻工、医药产品	饮食品	饮料、果菜汁
80克高白胶版印刷纸1105	轻工、医药产品	纸及制品(十类)	机制纸（新闻纸）
80克高白胶版印刷纸1250	轻工、医药产品	纸及制品(十类)	机制纸（新闻纸）
95克高白胶版印刷纸787	轻工、医药产品	纸及制品(十类)	机制纸（新闻纸）
58克高白胶版印刷纸1130	轻工、医药产品	纸及制品(十类)	机制纸（新闻纸）
58克高白胶版印刷纸1105	轻工、医药产品	纸及制品(十类)	机制纸（新闻纸）
58克高白胶版印刷纸1250	轻工、医药产品	纸及制品(十类)	机制纸（新闻纸）
75克高白胶版印刷纸787	轻工、医药产品	纸及制品(十类)	机制纸（新闻纸）
95克高白胶版印刷纸889	轻工、医药产品	纸及制品(十类)	机制纸（新闻纸）
80克高白胶版印刷纸880X1230	轻工、医药产品	纸及制品(十类)	机制纸（新闻纸）
槽钢20A	钢铁	钢 材、合金钢材	型材
75克高白胶版印刷纸889X1194	轻工、医药产品	纸及制品(十类)	机制纸（新闻纸）
75克高白胶版印刷纸787x1092	轻工、医药产品	纸及制品(十类)	机制纸（新闻纸）
65克高白胶版印刷纸787	轻工、医药产品	纸及制品(十类)	机制纸（新闻纸）
65克高白胶版印刷纸889	轻工、医药产品	纸及制品(十类)	机制纸（新闻纸）
68克高白胶版印刷纸875X810	轻工、医药产品	纸及制品(十类)	机制纸（新闻纸）
70克高白胶版印刷纸1055	轻工、医药产品	纸及制品(十类)	机制纸（新闻纸）
70克高白胶版印刷纸1205	轻工、医药产品	纸及制品(十类)	机制纸（新闻纸）
70克高白胶版印刷纸1105	轻工、医药产品	纸及制品(十类)	机制纸（新闻纸）
70克高白胶版印刷纸1130	轻工、医药产品	纸及制品(十类)	机制纸（新闻纸）
槽钢16A	钢铁	钢 材、合金钢材	型材
60克高白胶版印刷纸889	轻工、医药产品	纸及制品(十类)	机制纸（新闻纸）
75克高白胶版印刷纸851	轻工、医药产品	纸及制品(十类)	机制纸（新闻纸）
78克高白胶版印刷纸889X1194	轻工、医药产品	纸及制品(十类)	机制纸（新闻纸）
60克高白胶版印刷纸1250	轻工、医药产品	纸及制品(十类)	机制纸（新闻纸）
68克高白胶版印刷纸876	轻工、医药产品	纸及制品(十类)	机制纸（新闻纸）
75克高白胶版印刷纸870X592	轻工、医药产品	纸及制品(十类)	机制纸（新闻纸）
58克高白胶版印刷纸915	轻工、医药产品	纸及制品(十类)	机制纸（新闻纸）
58克高白胶版印刷纸787	轻工、医药产品	纸及制品(十类)	机制纸（新闻纸）
58克高白胶版印刷纸900	轻工、医药产品	纸及制品(十类)	机制纸（新闻纸）
70克高白胶版印刷纸1100	轻工、医药产品	纸及制品(十类)	机制纸（新闻纸）
55克高白胶版印刷纸900	轻工、医药产品	纸及制品(十类)	机制纸（新闻纸）
58克高白胶版印刷纸889	轻工、医药产品	纸及制品(十类)	机制纸（新闻纸）
57克高白胶版印刷纸787	轻工、医药产品	纸及制品(十类)	机制纸（新闻纸）
57克高白胶版印刷纸770	轻工、医药产品	纸及制品(十类)	机制纸（新闻纸）
57克高白胶版印刷纸889	轻工、医药产品	纸及制品(十类)	机制纸（新闻纸）
57克高白胶版印刷纸870	轻工、医药产品	纸及制品(十类)	机制纸（新闻纸）
58克高白胶版印刷纸1255	轻工、医药产品	纸及制品(十类)	机制纸（新闻纸）
58克高白胶版印刷纸1180	轻工、医药产品	纸及制品(十类)	机制纸（新闻纸）
56克高白胶版印刷纸787	轻工、医药产品	纸及制品(十类)	机制纸（新闻纸）
56克高白胶版印刷纸889	轻工、医药产品	纸及制品(十类)	机制纸（新闻纸）
55克高白胶版印刷纸1255	轻工、医药产品	纸及制品(十类)	机制纸（新闻纸）
55克高白胶版印刷纸935	轻工、医药产品	纸及制品(十类)	机制纸（新闻纸）
55克高白胶版印刷纸1040	轻工、医药产品	纸及制品(十类)	机制纸（新闻纸）
55克高白胶版印刷纸1044	轻工、医药产品	纸及制品(十类)	机制纸（新闻纸）
55克高白胶版印刷纸1030	轻工、医药产品	纸及制品(十类)	机制纸（新闻纸）
55克高白胶版印刷纸1198	轻工、医药产品	纸及制品(十类)	机制纸（新闻纸）
55克高白胶版印刷纸1188	轻工、医药产品	纸及制品(十类)	机制纸（新闻纸）
55克高白胶版印刷纸1088	轻工、医药产品	纸及制品(十类)	机制纸（新闻纸）
60克高白胶版印刷纸1050	轻工、医药产品	纸及制品(十类)	机制纸（新闻纸）
55克高白胶版印刷纸1092	轻工、医药产品	纸及制品(十类)	机制纸（新闻纸）
55克高白胶版印刷纸1420	轻工、医药产品	纸及制品(十类)	机制纸（新闻纸）
58克高白胶版印刷纸845	轻工、医药产品	纸及制品(十类)	机制纸（新闻纸）
冷卷冷板	钢铁	钢 材、合金钢材	卷材
汽车轮胎	机械设备、电器	橡胶	雕塑、刻、漆工艺品
PVC管	钢铁	钢铁制品	钢铁件及其它五金制品
PA管	钢铁	钢铁制品	钢铁件及其它五金制品
PP管	钢铁	钢铁制品	钢铁件及其它五金制品
PPR管	钢铁	钢铁制品	钢铁件及其它五金制品
PVC板	钢铁	钢 材、合金钢材	板材
人造石	轻工、医药产品	杂粮	其它
沙石	轻工、医药产品	日用工业品	其它日用品
大理石	非金属矿石	石灰石	其它
无缝管	钢铁	钢 材、合金钢材	管材及附件
金属丝绳	轻工、医药产品	纸及制品(十类)	印刷品
马口铁	钢铁	钢 材、合金钢材	板材
普通圆钢	钢铁	钢 材、合金钢材	线材
废电子电器	机械设备、电器	钢 材、合金钢材	制冷、加热、燃烧设备
阀门	机械设备、电器	普通工业机械及设备	通用设备
焊接设备	钢铁	钢 材、合金钢材	钢铁件及其它五金制品
车床	机械设备、电器	普通工业机械及设备	金属加工机械及设备
铣床	机械设备、电器	普通工业机械及设备	金属加工机械及设备
排焊机	机械设备、电器	专用机械、设备及制品	通用设备
切割机	机械设备、电器	专用机械、设备及制品	重工业机械、工程机械及零件
焊条	钢铁	钢铁制品	钢铁件及其它五金制品
泵	轻工、医药产品	文化体育用品	文教办公用品
油封	轻工、医药产品	日用工业品	钢铁容器
食品机械	机械设备、电器	饮食品	饮料、果菜汁
纺织机械	机械设备、电器	专用机械、设备及制品	重工业机械、工程机械及零件
服装机械	轻工、医药产品	针织、纺织、皮毛及制品	其它日用品
印刷设备	轻工、医药产品	纸及制品(十类)	纸板（原纸）
榨油机	机械设备、电器	普通工业机械及设备	锅炉、发动机 动力装置及辅助设备
散热器	机械设备、电器	普通工业机械及设备	电子、光、磁、超声波装置的元器件、零件、附件
线路板	钢铁	钢 材、合金钢材	管材及附件
电源	其它货类	其它	其它
充电器	机械设备、电器	电力设备、电器机械及器材	家用电器
发电机	钢铁	钢 材、合金钢材	板材
低压电器	机械设备、电器	电力设备、电器机械及器材	通用设备
继电器	机械设备、电器	电力设备、电器机械及器材	家用电器
断路器	机械设备、电器	电力设备、电器机械及器材	输变电设备
万用表	轻工、医药产品	日用工业品	其它日用品
网线	钢铁	钢铁制品	钢铁件及其它五金制品
天线	钢铁	钢 材、合金钢材	线材
汽车影音	机械设备、电器	仪器仪表、计量器具、工具	计量器具
电动车	机械设备、电器	交通运输设备	非机动车
自行车配件	机械设备、电器	交通运输设备	道路机动车辆
自行车	机械设备、电器	交通运输设备	道路机动车辆
三轮车	机械设备、电器	交通运输设备	其它运输辅件及器材
食用油加工设备	农、林、牧、渔业产品	经济作物及制品	其它
面膜	轻工、医药产品	饮食品	糕点、面食、谷物食品
爽肤水	轻工、医药产品	饮食品	饮料、果菜汁
粉饼	金属矿石	铁矿石	其它
粉底	金属矿石	铁矿石	其它
香水	机械设备、电器	普通工业机械及设备	仪器仪表
睫毛膏	化工原料及制品	日用化工品	美容化妆品
洗发水	轻工、医药产品	日用工业品	其它日用品
美发	轻工、医药产品	饮食品	酒（白酒、啤酒、果酒类）
剃须膏	化工原料及制品	日用化工品	其它
爽身粉	金属矿石	铁矿石	其它
洗手液	机械设备、电器	电力设备、电器机械及器材	其它电器设备
美发用具	轻工、医药产品	日用工业品	机制纸（新闻纸）
牙刷	轻工、医药产品	纸及制品(十类)	机制纸（新闻纸）
清洁剂	化工原料及制品	日用工业品	纸制品
餐具	轻工、医药产品	日用工业品	家具、坐具
家用称	轻工、医药产品	日用工业品	家具、坐具
沙发布	轻工、医药产品	纸及制品(十类)	家具、坐具
生活用纸	轻工、医药产品	纸及制品(十类)	纸浆
卫生纸	轻工、医药产品	纸及制品(十类)	其它纸及制品
卫生棉	轻工、医药产品	文化体育用品	文教办公用品
纸巾	轻工、医药产品	纸及制品(十类)	其它纸及制品
纸尿裤	轻工、医药产品	纸及制品(十类)	其它纸及制品
包装纸	轻工、医药产品	纸及制品(十类)	其它纸及制品
复印纸	轻工、医药产品	纸及制品(十类)	加工纸
办公纸	轻工、医药产品	纸及制品(十类)	其它纸及制品
玩具车	机械设备、电器	交通运输设备	重工业机械、工程机械及零件
婴儿玩具	轻工、医药产品	日用工业品	家具、坐具
十字绣	机械设备、电器	普通工业机械及设备	通用设备
圣诞树	农、林、牧、渔业产品	竹、木、藤、花、草	针织、纺织制品
棋牌	农、林、牧、渔业产品	竹、木、藤、花、草	花草
数码	轻工、医药产品	针织、纺织、皮毛及制品	其它
上网本	轻工、医药产品	纸及制品(十类)	针织、纺织制品
新塘牛仔	轻工、医药产品	文化体育用品	皮毛制品
精品女装	轻工、医药产品	铁矿石	其它
棉衣	轻工、医药产品	针织、纺织、皮毛及制品	服装
毛衣	轻工、医药产品	针织、纺织、皮毛及制品	服装
牛仔	轻工、医药产品	竹、木、藤、花、草	皮毛制品
童棉袄	轻工、医药产品	纸及制品(十类)	其它未列名针织、纺织、皮革及制品
背带裤	轻工、医药产品	针织、纺织、皮毛及制品	其它纸及制品
情侣内衣	机械设备、电器	普通工业机械及设备	其它运输辅件及器材
内衣	机械设备、电器	电子、电讯设备及器材	电工器材
女式内裤	钢铁	钢 材、合金钢材	管材及附件
男式内裤	钢铁	钢 材、合金钢材	管材及附件
鞋	轻工、医药产品	纸及制品(十类)	其它纸及制品
糖果鞋	轻工、医药产品	纸及制品(十类)	糖（固体、浆）
防水台鞋	轻工、医药产品	纸及制品(十类)	纸板（原纸）
板鞋	轻工、医药产品	其它	纸浆
丝巾	轻工、医药产品	针织、纺织、皮毛及制品	布匹（机织、绒织、网织物、纱罗）
袜子	轻工、医药产品	蔬菜、瓜果及籽实籽仁	金属制品
雪纺围巾	轻工、医药产品	针织、纺织、皮毛及制品	服装
鸭舌帽	轻工、医药产品	针织、纺织、皮毛及制品	服装
踩脚袜	轻工、医药产品	针织、纺织、皮毛及制品	服装
高筒袜	轻工、医药产品	饮食品	其它未列名饮食及调味食品
水晶饰品	轻工、医药产品	其它	其它
项链	轻工、医药产品	针织、纺织、皮毛及制品	其它
毛衣链	轻工、医药产品	针织、纺织、皮毛及制品	服装
银	农、林、牧、渔业产品	竹、木、藤、花、草	其它
纺织面料	轻工、医药产品	针织、纺织、皮毛及制品	针织、纺织制品
服装辅料	轻工、医药产品	针织、纺织、皮毛及制品	其它纸及制品
皮革	轻工、医药产品	针织、纺织、皮毛及制品	服装
坯布	轻工、医药产品	针织、纺织、皮毛及制品	布匹（机织、绒织、网织物、纱罗）
酒店茶几	轻工、医药产品	竹、木、藤、花、草	饮料、果菜汁
酒店梳妆台	轻工、医药产品	日用工业品	家具、坐具
电视柜	机械设备、电器	电力设备、电器机械及器材	家用电器
地柜	其它货类	其它	灯具、照明装置、发光标志、牌照
视听柜	轻工、医药产品	日用工业品	家具、坐具
书柜	轻工、医药产品	文化体育用品	其它
书架	钢铁	钢铁制品	线材
衣柜	轻工、医药产品	针织、纺织、皮毛及制品	服装
酒柜	轻工、医药产品	日用工业品	家具、坐具
储物柜	化工原料及制品	针织、纺织、皮毛及制品	其它
酒吧台	轻工、医药产品	饮食品	其它日用品
酒吧凳	轻工、医药产品	饮食品	其它日用品
衣帽架	轻工、医药产品	日用工业品	其它日用品
鞋柜鞋架	轻工、医药产品	纸及制品(十类)	纸板（原纸）
煮蛋器	机械设备、电器	电力设备、电器机械及器材	其它
咖啡机	机械设备、电器	专用机械、设备及制品	重工业机械、工程机械及零件
豆浆机	化工原料及制品	纸及制品(十类)	纸浆
打蛋器	机械设备、电器	其它	其它
水果刀	轻工、医药产品	饮食品	其它未列名饮食及调味食品
砧板	钢铁	钢 材、合金钢材	板材
榨汁机	机械设备、电器	专用机械、设备及制品	重工业机械、工程机械及零件
蛋糕模	化工原料及制品	交通运输设备	雕塑、刻、漆工艺品
家用净水器	轻工、医药产品	日用工业品	其它日用品
家用搅拌机	轻工、医药产品	日用工业品	针织、纺织制品
茶具	轻工、医药产品	日用工业品	陶瓷制品
酒具	轻工、医药产品	饮食品	酒（白酒、啤酒、果酒类）
咖啡具	轻工、医药产品	文化体育用品	糖果、蜜饯、果脯
碗	轻工、医药产品	文化体育用品	文教办公用品
牙签	轻工、医药产品	工艺美术品	雕塑、刻、漆工艺品
餐具套装	轻工、医药产品	饮食品	酒（白酒、啤酒、果酒类）
餐具附件	轻工、医药产品	日用工业品	家具、坐具
其他餐具	轻工、医药产品	日用工业品	家具、坐具
灶具	轻工、医药产品	文化体育用品	文教办公用品
燃气灶具	轻工、医药产品	文化体育用品	文教办公用品
电热炉	机械设备、电器	电子、电讯设备及器材	电子、光、磁、超声波装置的元器件、零件、附件
灶具配件	机械设备、电器	专用机械、设备及制品	轻工业机械及零件
其他灶具	轻工、医药产品	日用工业品	家具、坐具
电饭煲电饭锅	机械设备、电器	电力设备、电器机械及器材	家用电器
多士炉烤面包机	轻工、医药产品	工艺美术品	纸浆
烤箱	机械设备、电器	普通工业机械及设备	锅炉、发动机 动力装置及辅助设备
保温容器	机械设备、电器	交通运输设备	其它运输辅件及器材
热水瓶	机械设备、电器	钢铁制品	钢铁容器
热水袋	机械设备、电器	钢铁制品	电子、光、磁、超声波装置的元器件、零件、附件
家居日化	轻工、医药产品	日用工业品	家具、坐具
洗衣粉	轻工、医药产品	日用工业品	钟表、表零件
洗衣皂	轻工、医药产品	针织、纺织、皮毛及制品	服装
衣物柔顺剂	轻工、医药产品	针织、纺织、皮毛及制品	鞋帽
洗洁精	轻工、医药产品	文化体育用品	文教办公用品
厨房清洁剂	轻工、医药产品	日用工业品	卫生品(洗涤剂、皂类)
卫生间清洁剂	轻工、医药产品	日用工业品	家具、坐具
空气清新剂	轻工、医药产品	日用工业品	其它日用品
装修污染清除剂	粮食	其它未列名轻工产品	蔬菜
花露水	轻工、医药产品	饮食品	饮料、果菜汁
鞋用油蜡	轻工、医药产品	纸及制品(十类)	纸浆
鸡毛掸	轻工、医药产品	饮食品	酒（白酒、啤酒、果酒类）
地板清洁用品	轻工、医药产品	饮食品	其它日用品
鞋套机	轻工、医药产品	针织、纺织、皮毛及制品	鞋帽
擦鞋机	轻工、医药产品	针织、纺织、皮毛及制品	鞋帽
鞋刷	轻工、医药产品	纸及制品(十类)	机制纸（新闻纸）
浴帽	轻工、医药产品	针织、纺织、皮毛及制品	纱、线、丝、纤维（非复合材料）
牙刷架	轻工、医药产品	钢铁制品	茶叶、咖啡、可可（豆、粉）
洗衣用品	轻工、医药产品	日用工业品	鞋帽
衣架衣夹	轻工、医药产品	日用工业品	家具、坐具
塑料衣架	轻工、医药产品	针织、纺织、皮毛及制品	纸制品
金属衣架	轻工、医药产品	日用工业品	家具、坐具
植绒衣架	轻工、医药产品	日用工业品	家具、坐具
折叠衣架	轻工、医药产品	日用工业品	家具、坐具
裤架裤夹	轻工、医药产品	针织、纺织、皮毛及制品	针织、纺织制品
晾衣架	机械设备、电器	电力设备、电器机械及器材	家用电器
洗衣刷	轻工、医药产品	针织、纺织、皮毛及制品	其它纸及制品
衣帽刷	轻工、医药产品	纸及制品(十类)	其它纸及制品
洗衣篮	轻工、医药产品	针织、纺织、皮毛及制品	服装
洗衣袋	轻工、医药产品	日用工业品	鞋帽
毛球修剪器	轻工、医药产品	其它未列名轻工产品	雕塑、刻、漆工艺品
熨烫衣板	轻工、医药产品	针织、纺织、皮毛及制品	鞋帽
收纳内衣盒	机械设备、电器	普通工业机械及设备	其它运输辅件及器材
收纳架	钢铁	钢铁制品	钢铁件及其它五金制品
纸巾盒	轻工、医药产品	纸及制品(十类)	其它纸及制品
石英表	轻工、医药产品	工艺美术品	雕塑、刻、漆工艺品
家用血压计	轻工、医药产品	针织、纺织、皮毛及制品	针织、纺织制品
家用血糖仪	轻工、医药产品	饮食品	糕点、面食、谷物食品
家用衡器	轻工、医药产品	电力设备、电器机械及器材	家用电器
家用温度计	金属矿石	铁矿石	线材
其他家用衡器	轻工、医药产品	电力设备、电器机械及器材	家具、坐具
婴幼儿餐具	轻工、医药产品	日用工业品	家具、坐具
婴儿服装	轻工、医药产品	针织、纺织、皮毛及制品	服装
婴儿床上用品	轻工、医药产品	日用工业品	家具、坐具
婴儿卫生洗浴用品	轻工、医药产品	日用工业品	纺织材料絮胎及制品、短纤维屑、粉
床罩	轻工、医药产品	日用工业品	家具、坐具
靠垫抱枕	轻工、医药产品	日用工业品	家具、坐具
床单被单	轻工、医药产品	日用工业品	家具、坐具
毛毯	轻工、医药产品	针织、纺织、皮毛及制品	其它
餐具垫	轻工、医药产品	日用工业品	家具、坐具
微波炉手套	机械设备、电器	电力设备、电器机械及器材	其它日用品
面巾	轻工、医药产品	饮食品	糕点、面食、谷物食品
按材质分绸面料	轻工、医药产品	日用化工品	卫生品(洗涤剂、皂类)
色丁面料	轻工、医药产品	文化体育用品	乳制品，蜂蜜、王浆、粉
书法字画	轻工、医药产品	工艺美术品	其它
精品刺绣	轻工、医药产品	饮食品	其它工艺美术品
水晶家饰	轻工、医药产品	纸及制品(十类)	其它
玻璃家饰	轻工、医药产品	日用工业品	玻璃制品
十字绣套件	机械设备、电器	普通工业机械及设备	金属加工机械及设备
十字绣抱枕	机械设备、电器	普通工业机械及设备	电子、光、磁、超声波装置的元器件、零件、附件
文房用品	轻工、医药产品	饮食品	卫生品(洗涤剂、皂类)
竹地板	钢铁	钢 材、合金钢材	线材
实木地板	轻工、医药产品	纸及制品(十类)	纸板（原纸）
塑料地板	机械设备、电器	电子、电讯设备及器材	电子、光、磁、超声波装置的元器件、零件、附件
橡胶地板	化工原料及制品	纸及制品(十类)	其它
复合地板	轻工、医药产品	日用工业品	家具、坐具
防静电地板	机械设备、电器	钢铁制品	制冷、加热、燃烧设备
纱窗	轻工、医药产品	针织、纺织、皮毛及制品	纱、线、丝、纤维（非复合材料）
格栅灯	轻工、医药产品	日用工业品	灯具、照明装置、发光标志、牌照
毛巾杆	钢铁	钢铁制品	钢铁材料、结构体
燃气热水器	钢铁	钢 材、合金钢材	管材及附件
电热水器	机械设备、电器	电力设备、电器机械及器材	电子、光、磁、超声波装置的元器件、零件、附件
太阳能热水器	轻工、医药产品	电子、电讯设备及器材	电池、蓄电池
空气源热泵热水器	钢铁	钢 材、合金钢材	管材及附件
中央热水器	钢铁	钢 材、合金钢材	管材及附件
热水器配件	机械设备、电器	电力设备、电器机械及器材	家用电器
其他热水器	机械设备、电器	竹、木、藤、花、草	其它
排气换气扇	化工原料及制品	文化体育用品	针织、纺织制品
滚筒洗衣机	轻工、医药产品	日用工业品	家具、坐具
波轮洗衣机	机械设备、电器	电力设备、电器机械及器材	家用电器
双桶洗衣机	轻工、医药产品	日用工业品	家具、坐具
迷你洗衣机	轻工、医药产品	日用工业品	家具、坐具
脱水机	机械设备、电器	普通工业机械及设备	锅炉、发动机 动力装置及辅助设备
干衣机	轻工、医药产品	日用工业品	钟表、表零件
其他洗衣机干衣机	机械设备、电器	电力设备、电器机械及器材	家用电器
洗衣机干衣机配件	轻工、医药产品	日用工业品	钟表、表零件
微波炉	机械设备、电器	电力设备、电器机械及器材	钢铁容器
抽油烟机	农、林、牧、渔业产品	经济作物及制品	动植物食用油料、脂肪及制品
酸奶机	钢铁	钢 材、合金钢材	管材及附件
饮水机	机械设备、电器	电力设备、电器机械及器材	家用电器
家用空气净化器	机械设备、电器	电力设备、电器机械及器材	家用电器
家用除湿机	轻工、医药产品	日用工业品	针织、纺织制品
电风扇	机械设备、电器	电力设备、电器机械及器材	制冷、加热、燃烧设备
台扇	轻工、医药产品	饮食品	其它日用品
落地扇	轻工、医药产品	日用工业品	家具、坐具
吊扇	轻工、医药产品	针织、纺织、皮毛及制品	其它
壁扇	轻工、医药产品	针织、纺织、皮毛及制品	其它
剃须刀除毛器	轻工、医药产品	日用工业品	其它日用品
家用吸尘器	轻工、医药产品	日用工业品	针织、纺织制品
冰箱冷柜	机械设备、电器	电力设备、电器机械及器材	家用电器
冰箱冷柜配件	机械设备、电器	电力设备、电器机械及器材	家用电器
汽车空调	机械设备、电器	电力设备、电器机械及器材	家用电器
射线管彩电	钢铁	钢 材、合金钢材	管材及附件
接线插座	机械设备、电器	文化体育用品	纱、线、丝、纤维（非复合材料）
桌面插座	轻工、医药产品	文化体育用品	家具、坐具
音响产品	其它货类	其它	普通金属工艺品
汽车音响	机械设备、电器	仪器仪表、计量器具、工具	计量器具
组合音响	其它货类	针织、纺织、皮毛及制品	针织、纺织制品
音响配件	其它货类	其它	其它
其他音响产品	机械设备、电器	电力设备、电器机械及器材	家用电器
卡带机	钢铁	钢铁制品	钢铁件及其它五金制品
音频线视频线	机械设备、电器	电力设备、电器机械及器材	家用电器
电源线材	钢铁	钢铁制品	管材及附件
圆珠笔	其它货类	钢 材、合金钢材	其它
塑料圆珠笔	轻工、医药产品	纸及制品(十类)	罐头，硬、软包装食品
金属圆珠笔	轻工、医药产品	工艺美术品	其它
库存圆珠笔	轻工、医药产品	饮食品	酒（白酒、啤酒、果酒类）
签字笔-	轻工、医药产品	饮食品	其它
晨光签字笔	机械设备、电器	电子、电讯设备及器材	电子、光、磁、超声波装置的元器件、零件、附件
派签字笔	机械设备、电器	工艺美术品	普通金属工艺品
万宝龙签字笔	轻工、医药产品	针织、纺织、皮毛及制品	针织、纺织制品
记笔白板笔	轻工、医药产品	日用工业品	家具、坐具
油漆笔	轻工、医药产品	日用工业品	其它日用品
水溶笔	其它货类	其它	饮料、果菜汁
水解笔	其它货类	其它	饮料、果菜汁
家具笔	轻工、医药产品	日用工业品	家具、坐具
簿本册笔记本记事本	轻工、医药产品	文化体育用品	文教办公用品
相册	轻工、医药产品	针织、纺织、皮毛及制品	其它
水晶相册	轻工、医药产品	饮食品	饮料、果菜汁
纸面相册	轻工、医药产品	纸及制品(十类)	其它纸及制品
婚纱相册	化工原料及制品	日用化工品	纱、线、丝、纤维（非复合材料）
信封	其它货类	日用化工品	美容化妆品
气泡信封	机械设备、电器	钢铁制品	美容化妆品
快递信封	机械设备、电器	钢铁制品	电工器材
牛皮纸信封	轻工、医药产品	纸及制品(十类)	其它纸及制品
保密信封	钢铁	钢铁制品	钢铁材料、结构体
水果便签	轻工、医药产品	饮食品	其它未列名饮食及调味食品
水果便签纸	轻工、医药产品	饮食品	其它未列名饮食及调味食品
带笔便签本	轻工、医药产品	工艺美术品	其它
活页本线圈本	轻工、医药产品	日用化工品	文化办公机械、设备
线圈本	轻工、医药产品	工艺美术品	其它
线圈笔记本	机械设备、电器	钢 材、合金钢材	其它
金属线圈本	钢铁	钢铁制品	型材
信纸	轻工、医药产品	纸及制品(十类)	纸板（原纸）
墨水	其它货类	其它未列名非金属矿石	其它
隐形墨水	轻工、医药产品	饮食品	饮料、果菜汁
白板笔墨水	轻工、医药产品	饮食品	雕塑、刻、漆工艺品
中性墨水	轻工、医药产品	饮食品	其它
水彩笔墨水	轻工、医药产品	饮食品	饮料、果菜汁
荧光墨水	机械设备、电器	钢 材、合金钢材	其它
卷笔刀削笔器	轻工、医药产品	饮食品	其它未列名饮食及调味食品
塑料卷笔刀	轻工、医药产品	文化体育用品	其它
双孔卷笔刀	轻工、医药产品	文化体育用品	布匹（机织、绒织、网织物、纱罗）
造型卷笔刀	轻工、医药产品	饮食品	印刷品
动物卷笔刀	钢铁	铁矿石	其它
电动卷笔刀	机械设备、电器	钢 材、合金钢材	其它
笔架	钢铁	钢铁制品	钢铁件及其它五金制品
塑料笔架	化工原料及制品	工艺美术品	其它
玻璃笔座	轻工、医药产品	日用工业品	玻璃制品
毛笔笔架	轻工、医药产品	饮食品	其它
金属笔架	轻工、医药产品	经济作物及制品	其它
毛绒笔筒	轻工、医药产品	日用工业品	家具、坐具
尼龙书包	轻工、医药产品	文化体育用品	印刷品
墨汁	金属矿石	铁矿石	其它
牛津笔袋	轻工、医药产品	铁矿石	其它
书立书架	轻工、医药产品	文化体育用品	线材
看书架	钢铁	钢铁制品	线材
阅读看书架	轻工、医药产品	针织、纺织、皮毛及制品	印刷品
金属看书架	化工原料及制品	针织、纺织、皮毛及制品	印刷品
水彩笔套装	其它货类	经济作物及制品	饮料、果菜汁
其他学习文具桌上文具收纳用品	轻工、医药产品	日用工业品	家具、坐具
修正带	钢铁	钢铁制品	钢铁件及其它五金制品
文具胶带	轻工、医药产品	纸及制品(十类)	机制纸（新闻纸）
胶带座	轻工、医药产品	纸及制品(十类)	其它纸及制品
裁剪用品	轻工、医药产品	文化体育用品	卫生品(洗涤剂、皂类)
裁纸刀	轻工、医药产品	纸及制品(十类)	机制纸（新闻纸）
办公剪刀	轻工、医药产品	日用工业品	家具、坐具
美工刀	轻工、医药产品	日用工业品	其它日用品
其他裁剪用品	机械设备、电器	电力设备、电器机械及器材	家用电器
图书音像书籍	轻工、医药产品	文化体育用品	印刷品
录音带	钢铁	钢铁制品	钢铁件及其它五金制品
录像带	钢铁	钢铁制品	钢铁件及其它五金制品
期刊报纸	轻工、医药产品	文化体育用品	印刷品
期刊印刷	轻工、医药产品	纸及制品(十类)	机制纸（新闻纸）
期刊报纸印刷	轻工、医药产品	文化体育用品	印刷品
过期杂志批发	轻工、医药产品	工艺美术品	其它
挂历类	轻工、医药产品	饮食品	糕点、面食、谷物食品
挂历	轻工、医药产品	文化体育用品	其它文化体育用品
仿藤挂历	轻工、医药产品	饮食品	糖果、蜜饯、果脯
吸塑挂历	轻工、医药产品	工艺美术品	其它
毛绒挂历	轻工、医药产品	饮食品	糖果、蜜饯、果脯
中国结挂历	轻工、医药产品	饮食品	糕点、面食、谷物食品
福字挂历	轻工、医药产品	饮食品	其它未列名饮食及调味食品
年挂历	轻工、医药产品	饮食品	饮料、果菜汁
水晶台历	轻工、医药产品	饮食品	饮料、果菜汁
书刊印刷	轻工、医药产品	纸及制品(十类)	机制纸（新闻纸）
板式办公家具	轻工、医药产品	日用工业品	家具、坐具
墨盒墨水	轻工、医药产品	饮食品	雕塑、刻、漆工艺品
磁盘磁带	轻工、医药产品	纸及制品(十类)	纸板（原纸）
保险柜	其它货类	其它未列名化工原料及制品	其它
裁纸机	轻工、医药产品	纸及制品(十类)	纸板（原纸）
打字机刻字机	机械设备、电器	交通运输设备	其它运输辅件及器材
碎纸机	轻工、医药产品	纸及制品(十类)	纸板（原纸）
酒精灯	轻工、医药产品	饮食品	灯具、照明装置、发光标志、牌照
试剂瓶	化工原料及制品	钢铁制品	电工器材
发夹	钢铁	钢 材、合金钢材	管材及附件
发圈	钢铁	钢 材、合金钢材	管材及附件
发箍	钢铁	钢 材、合金钢材	管材及附件
仿真食品挂件	轻工、医药产品	饮食品	其它未列名饮食及调味食品
广告扇	轻工、医药产品	针织、纺织、皮毛及制品	布匹（机织、绒织、网织物、纱罗）
广告毛巾	轻工、医药产品	纸及制品(十类)	纺织材料包、套等，复合材料纱、线、绳
风扇	其它货类	日用化工品	卫生品(洗涤剂、皂类)
折叠水桶	轻工、医药产品	饮食品	饮料、果菜汁
台历挂历	轻工、医药产品	饮食品	文教办公用品
靠垫	轻工、医药产品	日用工业品	家具、坐具
手套玩具礼品	轻工、医药产品	日用工业品	家具、坐具
DIY玩具	轻工、医药产品	文化体育用品	文教办公用品
太阳能玩具	机械设备、电器	电子、电讯设备及器材	电子、光、磁、超声波装置的元器件、零件、附件
日用百货礼品创意家居礼品	轻工、医药产品	日用工业品	其它日用品
牙签筒	农、林、牧、渔业产品	竹、木、藤、花、草	雕塑、刻、漆工艺品
绕线器	机械设备、电器	电力设备、电器机械及器材	输变电设备
绒沙金	钢铁	钢铁制品	线材
鼎	农、林、牧、渔业产品	竹、木、藤、花、草	动植物食用油料、脂肪及制品
水晶玻璃	轻工、医药产品	日用工业品	其它日用品
家居装饰品	轻工、医药产品	针织、纺织、皮毛及制品	针织、纺织制品
草编品	农、林、牧、渔业产品	竹、木、藤、花、草	粟、黍、稷
竹编品	农、林、牧、渔业产品	竹、木、藤、花、草	竹
草帽	农、林、牧、渔业产品	竹、木、藤、花、草	花草
水果盘	矿物性建筑材料	石料及石制品	钢铁容器
水果篮	轻工、医药产品	饮食品	饮料、果菜汁
草编筐	化工原料及制品	其它未列名化工原料及制品	花草
布艺十字绣刺绣工艺品	机械设备、电器	交通运输设备	普通金属工艺品
品牌十字绣	机械设备、电器	普通工业机械及设备	其它运输辅件及器材
手工刺绣	轻工、医药产品	针织、纺织、皮毛及制品	纸浆
单面绣	轻工、医药产品	针织、纺织、皮毛及制品	布匹（机织、绒织、网织物、纱罗）
双面绣	轻工、医药产品	针织、纺织、皮毛及制品	布匹（机织、绒织、网织物、纱罗）
十字绣配附件	机械设备、电器	普通工业机械及设备	通用设备
成品十字绣	机械设备、电器	钢铁制品	管材及附件
树脂工艺品招财风水工艺品	轻工、医药产品	工艺美术品	雕塑、刻、漆工艺品
树脂人偶	化工原料及制品	杂粮	雕塑、刻、漆工艺品
树脂相框	化工原料及制品	电子、电讯设备及器材	合成树脂、聚合物
合成树脂	轻工、医药产品	针织、纺织、皮毛及制品	合成树脂、聚合物
仿古工艺品	轻工、医药产品	工艺美术品	其它工艺美术品
树脂摆件	化工原料及制品	电子、电讯设备及器材	电子、光、磁、超声波装置的元器件、零件、附件
工艺伞	轻工、医药产品	日用工业品	酒（白酒、啤酒、果酒类）
手工艺品	轻工、医药产品	日用工业品	酒（白酒、啤酒、果酒类）
竹雕竹刻	农、林、牧、渔业产品	竹、木、藤、花、草	竹
纸制工艺品手工艺品	轻工、医药产品	纸及制品(十类)	机制纸（新闻纸）
剪纸	轻工、医药产品	纸及制品(十类)	其它纸及制品
折纸	轻工、医药产品	纸及制品(十类)	其它纸及制品
纸雕	轻工、医药产品	纸及制品(十类)	其它纸及制品
工艺纸	轻工、医药产品	纸及制品(十类)	纸板（原纸）
宣纸艺品	轻工、医药产品	纸及制品(十类)	机制纸（新闻纸）
十字绣加工	钢铁	钢铁制品	管材及附件
大理石艺品	轻工、医药产品	工艺美术品	雕塑、刻、漆工艺品
汉白玉艺品	轻工、医药产品	饮食品	其它未列名饮食及调味食品
皮毛羽毛工艺品面具脸谱	轻工、医药产品	针织、纺织、皮毛及制品	鞋帽
羽毛面具	轻工、医药产品	饮食品	糕点、面食、谷物食品
羽毛扇	轻工、医药产品	针织、纺织、皮毛及制品	服装
皮毛动物	机械设备、电器	专用机械、设备及制品	通用设备
羽毛绒	轻工、医药产品	针织、纺织、皮毛及制品	服装
羽毛圣诞树	轻工、医药产品	工艺美术品	纸浆
毛球挂件	矿物性建筑材料	铁矿石	其它
仿玉工艺品	轻工、医药产品	工艺美术品	其它工艺美术品
发光棒	钢铁	钢 材、合金钢材	管材及附件
发光冰块	钢铁	钢 材、合金钢材	管材及附件
喜字	钢铁	钢铁制品	钢铁容器
情侣玩具	轻工、医药产品	日用工业品	文教办公用品
情侣餐具	轻工、医药产品	日用工业品	家具、坐具
福字	钢铁	钢铁制品	钢铁容器
南瓜灯	轻工、医药产品	日用工业品	灯具、照明装置、发光标志、牌照
鬼节面具	轻工、医药产品	饮食品	糕点、面食、谷物食品
万圣节服装	轻工、医药产品	文化体育用品	家具、坐具
果冻蜡烛	轻工、医药产品	饮食品	其它未列名饮食及调味食品
玻璃烛台	轻工、医药产品	日用工业品	玻璃制品
水晶烛台	轻工、医药产品	饮食品	饮料、果菜汁
树脂烛台	化工原料及制品	其它未列名矿建材料	管材及附件
家居摆挂饰办公摆挂饰	轻工、医药产品	日用工业品	文教办公用品
字画	农、林、牧、渔业产品	竹、木、藤、花、草	其它
油画	轻工、医药产品	日用工业品	钢铁容器
水粉画	轻工、医药产品	饮食品	其它
水彩画	其它货类	其它	饮料、果菜汁
树脂附件	机械设备、电器	专用机械、设备及制品	管材及附件
线香	钢铁	钢 材、合金钢材	线材
人造花	农、林、牧、渔业产品	经济作物及制品	动植物食用油料、脂肪及制品
树脂	化工原料及制品	化工品	合成树脂、聚合物
鱼干鱼丝	轻工、医药产品	文化体育用品	陶瓷制品
罐头食品	轻工、医药产品	饮食品	其它未列名饮食及调味食品
水产罐头	轻工、医药产品	饮食品	其它
水果罐头	轻工、医药产品	饮食品	茶叶、咖啡、可可（豆、粉）
其他罐头食品	轻工、医药产品	日用工业品	其它未列名饮食及调味食品
大米	有色金属	铝	其它
米粉	金属矿石	铁矿石	其它
粉丝粉皮	钢铁	钢 材、合金钢材	钢铁容器
方糖	轻工、医药产品	饮食品	糖（固体、浆）
猪肉	农、林、牧、渔业产品	畜、禽、兽及制品	蔬菜
牛肉	农、林、牧、渔业产品	畜、禽、兽及制品	蔬菜
羊肉	农、林、牧、渔业产品	畜、禽、兽及制品	蔬菜
鸡肉	农、林、牧、渔业产品	饮食品	其它未列名饮食及调味食品
鸭肉	农、林、牧、渔业产品	畜、禽、兽及制品	蔬菜
鹅肉	农、林、牧、渔业产品	畜、禽、兽及制品	蔬菜
兔肉	农、林、牧、渔业产品	畜、禽、兽及制品	蔬菜
脱水蔬菜	轻工、医药产品	饮食品	其它未列名饮食及调味食品
三级抗震8盘螺	钢铁	钢 材、合金钢材	线材
三级抗震盘螺10	钢铁	钢 材、合金钢材	线材
三级抗震盘螺6	钢铁	钢 材、合金钢材	线材
三级抗震盘螺8	钢铁	钢 材、合金钢材	线材
三级螺纹6mm盘螺	钢铁	钢 材、合金钢材	线材
三级抗震盘螺	钢铁	钢 材、合金钢材	线材
8三级抗震盘螺	钢铁	钢 材、合金钢材	线材
25盘螺抗震	钢铁	钢 材、合金钢材	线材
10盘螺抗震	钢铁	钢 材、合金钢材	线材
三级盘螺8抗震	钢铁	钢 材、合金钢材	线材
三级抗震10盘螺	钢铁	钢 材、合金钢材	线材
三级螺纹8盘螺	钢铁	钢 材、合金钢材	线材
8盘螺抗震	钢铁	钢 材、合金钢材	线材
三级盘螺8和10	钢铁	钢 材、合金钢材	线材
螺纹盘螺	钢铁	钢 材、合金钢材	线材
盘螺、螺纹	钢铁	钢 材、合金钢材	线材
螺纹、盘螺	钢铁	钢 材、合金钢材	线材
带钢	钢铁	钢铁制品	钢铁材料、结构体
黑螺旋管	钢铁	钢 材、合金钢材	管材及附件
螺旋管0321补单	钢铁	钢 材、合金钢材	管材及附件
棉花	农、林、牧、渔业产品	棉花	其它
新疆棉	轻工、医药产品	纸及制品(十类)	其它纸及制品
9米螺纹晚上发货	钢铁	钢 材、合金钢材	线材
棉花包	轻工、医药产品	针织、纺织、皮毛及制品	布匹（机织、绒织、网织物、纱罗）
铝带	钢铁	钢 材、合金钢材	钢铁件及其它五金制品
螺纹水陆联运	钢铁	钢铁制品	钢铁件及其它五金制品
镀锌带方管	钢铁	钢 材、合金钢材	管材及附件
踏板扣件	钢铁	专用机械、设备及制品	电池、蓄电池
镀锌带方矩管	钢铁	钢 材、合金钢材	管材及附件
镀锌带圆管	钢铁	钢铁制品	钢铁件及其它五金制品
减速机	机械设备、电器	普通工业机械及设备	通用设备
一票制螺纹今天晚上发	钢铁	钢 材、合金钢材	线材
镀锌带方距圆管	钢铁	钢 材、合金钢材	管材及附件
带钢汽运	钢铁	钢铁制品	钢铁材料、结构体
螺纹一票制今天发	钢铁	钢 材、合金钢材	线材
螺纹水运	钢铁	钢 材、合金钢材	线材
船	钢铁	钢 材、合金钢材	管材及附件
预埋板	钢铁	钢 材、合金钢材	板材
螺旋管襄汾	钢铁	钢 材、合金钢材	管材及附件
螺纹一票制中标价必须干否则暂停招标资格	钢铁	钢 材、合金钢材	线材
螺旋管东明县沙窝乡	钢铁	钢 材、合金钢材	管材及附件
螺纹一票制运输新政	钢铁	钢 材、合金钢材	线材
螺旋管咸阳	钢铁	钢 材、合金钢材	管材及附件
螺旋管指定太原恒帅	钢铁	钢 材、合金钢材	管材及附件
长治市屯留县螺旋管	钢铁	钢 材、合金钢材	管材及附件
太原恒帅螺旋管指定	钢铁	钢 材、合金钢材	管材及附件
太原恒帅螺旋管	钢铁	钢 材、合金钢材	管材及附件
10克精致轻量涂纸	轻工、医药产品	饮食品	其它未列名饮食及调味食品
带钢外地库	钢铁	钢铁制品	钢铁件及其它五金制品
豆瓣	粮食	杂粮	其它
芝麻	轻工、医药产品	针织、纺织、皮毛及制品	其它
扁钢	钢铁	钢 材、合金钢材	型材
铜精矿	金属矿石	铁矿石	其它
万能铣床	轻工、医药产品	日用工业品	家具、坐具
哈尔滨冰纯91度500ML1X12纸箱听装带提手	机械设备、电器	电力设备、电器机械及器材	家用电器
百威97度500ML1X12纸箱听装带提手	轻工、医药产品	纸及制品(十类)	其它
红麻石材	农、林、牧、渔业产品	竹、木、藤、花、草	家 禽
螺纹盘螺山西永兴03509	钢铁	钢 材、合金钢材	线材
带钢v	钢铁	钢铁制品	钢铁材料、结构体
阳极板	钢铁	钢 材、合金钢材	板材
热度螺旋管	钢铁	钢 材、合金钢材	管材及附件
1车黑方直发江阴地址G2转S38到华西出口下到江阴市华士红苗工业区勤丰路	钢铁	钢 材、合金钢材	管材及附件
螺旋管6支920的包车一票制	钢铁	钢 材、合金钢材	管材及附件
濮阳热力公司3车螺旋管	机械设备、电器	专用机械、设备及制品	电子、光、磁、超声波装置的元器件、零件、附件
精密仪器	轻工、医药产品	竹、木、藤、花、草	其它
盘螺螺纹拼车	钢铁	钢 材、合金钢材	线材
A螺旋管	钢铁	钢 材、合金钢材	管材及附件
螺纹盘螺拼车	钢铁	钢 材、合金钢材	线材
70克高强纸袋纸1120	轻工、医药产品	纸及制品(十类)	纸板（原纸）
压缩机零件	机械设备、电器	普通工业机械及设备	通用设备
70克高强纸袋纸920	轻工、医药产品	纸及制品(十类)	纸板（原纸）
80克高强纸袋纸790	轻工、医药产品	纸及制品(十类)	纸板（原纸）
75克高强纸袋纸760	轻工、医药产品	纸及制品(十类)	纸板（原纸）
80克高强纸袋纸830	轻工、医药产品	纸及制品(十类)	纸板（原纸）
75克高强纸袋纸1020	轻工、医药产品	纸及制品(十类)	纸板（原纸）
80克高强纸袋纸760	轻工、医药产品	纸及制品(十类)	纸板（原纸）
75克高强纸袋纸1065	轻工、医药产品	纸及制品(十类)	纸板（原纸）
80克高强纸袋纸780	轻工、医药产品	纸及制品(十类)	纸板（原纸）
75克高强纸袋纸830	轻工、医药产品	纸及制品(十类)	纸板（原纸）
75克高强纸袋纸1194	轻工、医药产品	纸及制品(十类)	纸板（原纸）
75克高强纸袋纸790	轻工、医药产品	纸及制品(十类)	纸板（原纸）
螺旋管500x7x12米	钢铁	钢 材、合金钢材	管材及附件
75克高强纸袋纸1120	轻工、医药产品	纸及制品(十类)	纸板（原纸）
带钢、	钢铁	钢铁制品	钢铁材料、结构体
70克高强纸袋纸1150	轻工、医药产品	纸及制品(十类)	纸板（原纸）
75克高强纸袋纸1092	轻工、医药产品	纸及制品(十类)	纸板（原纸）
玉米皮	轻工、医药产品	其它	烟叶、烟草、卷烟、雪茄及代用品
棉沙	轻工、医药产品	针织、纺织、皮毛及制品	布匹（机织、绒织、网织物、纱罗）
l带钢	钢铁	钢铁制品	钢铁材料、结构体
75克高强纸袋纸1220	轻工、医药产品	纸及制品(十类)	纸板（原纸）
铜杯	轻工、医药产品	工艺美术品	普通金属工艺品
镀锌带圆管鲁HH1960	钢铁	钢铁制品	钢铁件及其它五金制品
镀锌带圆管苏C6J182	钢铁	钢铁制品	钢铁件及其它五金制品
。带钢	钢铁	钢铁制品	钢铁材料、结构体
镀锌带方矩管鲁H7N721	钢铁	钢 材、合金钢材	管材及附件
镀锌带方矩管鲁H7G020	钢铁	钢 材、合金钢材	管材及附件
镀锌带方矩管冀DH5693	钢铁	钢 材、合金钢材	管材及附件
镀锌带方矩管鲁HW2256	钢铁	钢 材、合金钢材	管材及附件
80克高强纸袋纸1180	轻工、医药产品	纸及制品(十类)	纸板（原纸）
80克高强纸袋纸1230	轻工、医药产品	纸及制品(十类)	纸板（原纸）
80克高强纸袋纸1120	轻工、医药产品	纸及制品(十类)	纸板（原纸）
镀锌带方矩管冀DF1084	钢铁	钢 材、合金钢材	管材及附件
70克精制轻量涂纸889X1194	轻工、医药产品	纸及制品(十类)	机制纸（新闻纸）
70克胶版纸印刷880	轻工、医药产品	纸及制品(十类)	机制纸（新闻纸）
楼板	钢铁	钢 材、合金钢材	板材
l螺旋管	钢铁	钢 材、合金钢材	管材及附件
棉花GYG	农、林、牧、渔业产品	棉花	其它
镀锌带圆管鲁H7Q891	钢铁	钢铁制品	钢铁件及其它五金制品
70克高强纸袋纸770	轻工、医药产品	纸及制品(十类)	纸板（原纸）
75克高强纸袋纸1040	轻工、医药产品	纸及制品(十类)	纸板（原纸）
螺纹%2b盘螺	钢铁	钢 材、合金钢材	线材
115克高强纸袋纸880	轻工、医药产品	纸及制品(十类)	纸板（原纸）
带钢30	钢铁	钢铁制品	钢铁材料、结构体
带钢卷	钢铁	钢 材、合金钢材	铸、锻钢材
d带钢	钢铁	钢铁制品	钢铁材料、结构体
啤酒空瓶	轻工、医药产品	日用工业品	玻璃制品
螺纹 盘螺	钢铁	钢 材、合金钢材	线材
螺旋管33T	钢铁	钢 材、合金钢材	管材及附件
版纸	轻工、医药产品	纸及制品(十类)	纸板（原纸）
盘螺%2b螺纹	钢铁	钢 材、合金钢材	线材
盘螺螺纹	钢铁	钢 材、合金钢材	线材
80克精品纯质纸	轻工、医药产品	纸及制品(十类)	机制纸（新闻纸）
棉包PHJ	轻工、医药产品	针织、纺织、皮毛及制品	布匹（机织、绒织、网织物、纱罗）
带钢，	钢铁	钢铁制品	钢铁材料、结构体
棉花SCY	农、林、牧、渔业产品	棉花	其它
盘螺HRB400E8螺	钢铁	钢 材、合金钢材	线材
带钢348×2.5	钢铁	钢铁制品	钢铁件及其它五金制品
带钢352×2.5	钢铁	钢铁制品	钢铁件及其它五金制品
带钢358×2.5	钢铁	钢铁制品	钢铁件及其它五金制品
355×2.5带钢	钢铁	钢铁制品	钢铁件及其它五金制品
348×2.75带钢	钢铁	钢铁制品	钢铁件及其它五金制品
352×2.5带钢	钢铁	钢铁制品	钢铁件及其它五金制品
带钢352×2.75	钢铁	钢铁制品	钢铁件及其它五金制品
带钢355×2.75	钢铁	钢铁制品	钢铁件及其它五金制品
带钢348×2.75	钢铁	钢铁制品	钢铁件及其它五金制品
带钢352×2.0	钢铁	钢铁制品	钢铁件及其它五金制品
带钢315×1.5	钢铁	钢铁制品	钢铁件及其它五金制品
带钢315×2.5	钢铁	钢铁制品	钢铁件及其它五金制品
带钢315×2.0	钢铁	钢铁制品	钢铁件及其它五金制品
带钢315×1.8	钢铁	钢铁制品	钢铁件及其它五金制品
带钢315×3.75	钢铁	钢铁制品	钢铁件及其它五金制品
带钢315×2.75	钢铁	钢铁制品	钢铁件及其它五金制品
带钢315×3.5	钢铁	钢铁制品	钢铁件及其它五金制品
带钢305×2.0	钢铁	钢铁制品	钢铁件及其它五金制品
带钢295/1.8	钢铁	钢铁制品	钢铁材料、结构体
带钢305×1.5	钢铁	钢铁制品	钢铁件及其它五金制品
带钢305×1.8	钢铁	钢铁制品	钢铁件及其它五金制品
带钢295×1.5	钢铁	钢铁制品	钢铁件及其它五金制品
带钢295×2.0	钢铁	钢铁制品	钢铁件及其它五金制品
带钢295×1.8	钢铁	钢铁制品	钢铁件及其它五金制品
带钢295/2.5	钢铁	钢铁制品	钢铁材料、结构体
带钢295/2.0	钢铁	钢铁制品	钢铁材料、结构体
带钢2995×2.0	钢铁	钢铁制品	钢铁件及其它五金制品
带钢295×2.5	钢铁	钢铁制品	钢铁件及其它五金制品
带钢315/1.8	钢铁	钢铁制品	钢铁材料、结构体
带钢315/2.5	钢铁	钢铁制品	钢铁材料、结构体
带钢295×3.75	钢铁	钢铁制品	钢铁件及其它五金制品
带钢295×3.5	钢铁	钢铁制品	钢铁件及其它五金制品
带钢295×2.75	钢铁	钢铁制品	钢铁件及其它五金制品
带钢305×2.5	钢铁	钢铁制品	钢铁件及其它五金制品
80克高强纸袋纸	轻工、医药产品	纸及制品(十类)	纸板（原纸）
机床罩壳	机械设备、电器	工艺美术品	其它
带钢303×2.75	钢铁	钢铁制品	钢铁件及其它五金制品
带钢303×2.2	钢铁	钢铁制品	钢铁件及其它五金制品
带钢303×2.0	钢铁	钢铁制品	钢铁件及其它五金制品
带钢303×3.25	钢铁	钢铁制品	钢铁件及其它五金制品
带钢295×3.0	钢铁	钢铁制品	钢铁件及其它五金制品
带钢295×3.25	钢铁	钢铁制品	钢铁件及其它五金制品
带钢312×2.5	钢铁	钢铁制品	钢铁件及其它五金制品
带钢312×2.75	钢铁	钢铁制品	钢铁件及其它五金制品
75克高强纸袋纸	轻工、医药产品	纸及制品(十类)	纸板（原纸）
带钢312×3.0	钢铁	钢铁制品	钢铁件及其它五金制品
带钢312×3.75	钢铁	钢铁制品	钢铁件及其它五金制品
带钢295×2.95	钢铁	钢铁制品	钢铁件及其它五金制品
带钢295×3.2	钢铁	钢铁制品	钢铁件及其它五金制品
带钢295×3.45	钢铁	钢铁制品	钢铁件及其它五金制品
带钢295×2.7	钢铁	钢铁制品	钢铁件及其它五金制品
豪正牌平板普通无碳纸	农、林、牧、渔业产品	铁矿石	其它
带钢292×2.75	钢铁	钢铁制品	钢铁件及其它五金制品
带钢315×2.2	钢铁	钢铁制品	钢铁件及其它五金制品
带钢292×3.0	钢铁	钢铁制品	钢铁件及其它五金制品
带钢292×2.5	钢铁	钢铁制品	钢铁件及其它五金制品
带钢312×3.5	钢铁	钢铁制品	钢铁件及其它五金制品
带钢315×2.4	钢铁	钢铁制品	钢铁件及其它五金制品
带钢292×3.75	钢铁	钢铁制品	钢铁件及其它五金制品
带钢292×3.5	钢铁	钢铁制品	钢铁件及其它五金制品
带钢303×2.4	钢铁	钢铁制品	钢铁件及其它五金制品
带钢303×2.65	钢铁	钢铁制品	钢铁件及其它五金制品
盘螺航	钢铁	钢 材、合金钢材	线材
螺纹金博泰	钢铁	钢铁制品	线材
带钢303×2.9	钢铁	钢铁制品	钢铁件及其它五金制品
带钢水运	机械设备、电器	钢铁制品	钢铁容器
带钢292×3.25	钢铁	钢铁制品	钢铁件及其它五金制品
80高强纸袋纸	轻工、医药产品	纸及制品(十类)	纸板（原纸）
带钢352×3.75	钢铁	钢铁制品	钢铁件及其它五金制品
带钢352×2.4	钢铁	钢铁制品	钢铁件及其它五金制品
带钢352×3.25	钢铁	钢铁制品	钢铁件及其它五金制品
带钢352×4.0	钢铁	钢铁制品	钢铁件及其它五金制品
带钢352×3.5	钢铁	钢铁制品	钢铁件及其它五金制品
带钢352×3.4	钢铁	钢铁制品	钢铁件及其它五金制品
带钢352×3.65	钢铁	钢铁制品	钢铁件及其它五金制品
带钢352×4.9	钢铁	钢铁制品	钢铁件及其它五金制品
带钢325×3.65	钢铁	钢铁制品	钢铁件及其它五金制品
带钢352×3.0	钢铁	钢铁制品	钢铁件及其它五金制品
带钢350×3.75	钢铁	钢铁制品	钢铁件及其它五金制品
630螺旋管	钢铁	钢 材、合金钢材	管材及附件
带钢31×3.0	钢铁	钢铁制品	钢铁件及其它五金制品
发浙江杭州淳安县左口乡1车螺旋管30吨	钢铁	钢 材、合金钢材	管材及附件
带钢295×2.9	钢铁	钢铁制品	钢铁件及其它五金制品
带钢295×2.2	钢铁	钢铁制品	钢铁件及其它五金制品
312×3.75带钢	钢铁	钢铁制品	钢铁件及其它五金制品
312×3.5带钢	钢铁	钢铁制品	钢铁件及其它五金制品
发浙江杭州淳安县左口乡螺旋管	钢铁	钢 材、合金钢材	管材及附件
305×4.75带钢	钢铁	钢铁制品	钢铁件及其它五金制品
卷筒无碳纸	轻工、医药产品	纸及制品(十类)	乳制品，蜂蜜、王浆、粉
带钢929×2.75	钢铁	钢铁制品	钢铁件及其它五金制品
带钢295×2.65	钢铁	钢铁制品	钢铁件及其它五金制品
卷筒普票专用纸	钢铁	钢 材、合金钢材	板材
螺纹金刚	钢铁	钢 材、合金钢材	线材
带钢HTR汽运	钢铁	钢铁制品	钢铁材料、结构体
三级抗震钢盘螺	钢铁	钢 材、合金钢材	线材
抗震盘螺	钢铁	钢 材、合金钢材	线材
抗震螺纹	钢铁	钢 材、合金钢材	线材
钢材螺纹	钢铁	钢 材、合金钢材	线材
开平板	钢铁	钢 材、合金钢材	板材
高线	钢铁	钢 材、合金钢材	线材
直缝焊管	钢铁	钢 材、合金钢材	管材及附件
冷拔丝	钢铁	钢铁制品	钢铁件及其它五金制品
味精	轻工、医药产品	饮食品	其它未列名饮食及调味食品
猛开平板	钢铁	钢 材、合金钢材	板材
锰开平板	钢铁	钢 材、合金钢材	板材
原味料酒	轻工、医药产品	饮食品	其它未列名饮食及调味食品
卷开平板	钢铁	钢 材、合金钢材	板材
金鼎小札浓香菜籽油	农、林、牧、渔业产品	经济作物及制品	动植物食用油料、脂肪及制品
金鼎纯香菜籽油	农、林、牧、渔业产品	经济作物及制品	动植物食用油料、脂肪及制品
金鼎食用调和油纸箱	农、林、牧、渔业产品	经济作物及制品	动植物食用油料、脂肪及制品
白砂糖	轻工、医药产品	饮食品	糖（固体、浆）
生活家围裙	轻工、医药产品	针织、纺织、皮毛及制品	服装
三级盘螺抗震	钢铁	钢 材、合金钢材	线材
三级螺钢微锈	钢铁	钢 材、合金钢材	线材
压缩机	机械设备、电器	普通工业机械及设备	通用设备
矿泉水	轻工、医药产品	饮食品	饮料、果菜汁
酸洗板	钢铁	钢 材、合金钢材	板材
板材	钢铁	钢 材、合金钢材	板材
空调压缩机	机械设备、电器	专用机械、设备及制品	制冷、加热、燃烧设备
硅钢卷	钢铁	钢 材、合金钢材	卷材
无缝钢	钢铁	钢 材、合金钢材	管材及附件
食用油	农、林、牧、渔业产品	经济作物及制品	动植物食用油料、脂肪及制品
冷轧卷	钢铁	钢 材、合金钢材	卷材
服装	轻工、医药产品	针织、纺织、皮毛及制品	服装
通讯器材	机械设备、电器	电子、电讯设备及器材	其它媒体及附件
酸洗卷	钢铁	钢 材、合金钢材	卷材
低合金	钢铁	生铁、铁合金、非合金钢	铁合金
全乳胶	化工原料及制品	橡胶	橡胶制品
不锈钢板	钢铁	钢 材、合金钢材	板材
纷美原纸	轻工、医药产品	纸及制品(十类)	其它纸及制品
金鼎小榨浓香菜籽油	农、林、牧、渔业产品	经济作物及制品	动植物食用油料、脂肪及制品
容器板	钢铁	钢 材、合金钢材	板材
冷轧板	钢铁	钢 材、合金钢材	板材
橡胶	化工原料及制品	橡胶	合成橡胶
文具	轻工、医药产品	文化体育用品	文教办公用品
可可粉	轻工、医药产品	饮食品	茶叶、咖啡、可可（豆、粉）
大型复印机	机械设备、电器	专用机械、设备及制品	文化办公机械、设备
电池片	机械设备、电器	电子、电讯设备及器材	电子、光、磁、超声波装置的元器件、零件、附件
格力电器	机械设备、电器	电力设备、电器机械及器材	家用电器
水果	农、林、牧、渔业产品	饮食品	其它
瑞雪双胶	轻工、医药产品	纸及制品(十类)	机制纸（新闻纸）
白象方便面	轻工、医药产品	饮食品	糕点、面食、谷物食品
小家电	机械设备、电器	电力设备、电器机械及器材	家用电器
可乐	轻工、医药产品	饮食品	饮料、果菜汁
铜排	轻工、医药产品	工艺美术品	普通金属工艺品
可口可乐	轻工、医药产品	饮食品	饮料、果菜汁
灯具	轻工、医药产品	日用工业品	灯具、照明装置、发光标志、牌照
汽车	机械设备、电器	交通运输设备	道路机动车辆
商品车	机械设备、电器	交通运输设备	道路机动车辆
海尔电器	机械设备、电器	电力设备、电器机械及器材	家用电器
箔坯	有色金属	铝	精铝及铝材
硬脂酸	钢铁	钢 材、合金钢材	管材及附件
电力设备	机械设备、电器	电力设备、电器机械及器材	家用电器
空调机	机械设备、电器	电力设备、电器机械及器材	家用电器
红酒箱	轻工、医药产品	饮食品	酒（白酒、啤酒、果酒类）
大豆	农、林、牧、渔业产品	经济作物及制品	经济作物原料、残渣及副产品
球团	金属矿石	铁矿石	其它
精印双胶纸	轻工、医药产品	纸及制品(十类)	纸板（原纸）
碎石料	轻工、医药产品	工艺美术品	雕塑、刻、漆工艺品
陶瓷	轻工、医药产品	日用工业品	陶瓷制品
白方	钢铁	钢 材、合金钢材	管材及附件
老板吸油烟机	机械设备、电器	电力设备、电器机械及器材	家用电器
热镀管发松江	钢铁	钢 材、合金钢材	管材及附件
轻质铜纸板	轻工、医药产品	纸及制品(十类)	纸板（原纸）
器材	轻工、医药产品	文化体育用品	体育运动用品及零件、附件
乐器	轻工、医药产品	文化体育用品	演艺器材及用品
调料	轻工、医药产品	饮食品	其它未列名饮食及调味食品
花生油	农、林、牧、渔业产品	经济作物及制品	动植物食用油料、脂肪及制品
全木浆胶纸板	轻工、医药产品	纸及制品(十类)	纸板（原纸）
焊管热镀	钢铁	钢 材、合金钢材	管材及附件
三防热敏原纸	钢铁	钢 材、合金钢材	管材及附件
医疗设备	机械设备、电器	专用机械、设备及制品	医疗器械（具）、设备
面包	轻工、医药产品	文化体育用品	陶瓷制品
电容器设备	机械设备、电器	电子、电讯设备及器材	电子、光、磁、超声波装置的元器件、零件、附件
电压互感器设备	机械设备、电器	电子、电讯设备及器材	电子、光、磁、超声波装置的元器件、零件、附件
口罩	轻工、医药产品	针织、纺织、皮毛及制品	其它未列名针织、纺织、皮革及制品
精品绵竹头曲	轻工、医药产品	饮食品	其它未列名饮食及调味食品
吸油烟机	农、林、牧、渔业产品	经济作物及制品	动植物食用油料、脂肪及制品
鸡精宣传品	轻工、医药产品	饮食品	其它未列名饮食及调味食品
压缩机附件	机械设备、电器	专用机械、设备及制品	制冷、加热、燃烧设备
红标绵竹大曲	农、林、牧、渔业产品	竹、木、藤、花、草	竹
乳液	化工原料及制品	日用化工品	美容化妆品
绝缘纸	轻工、医药产品	纸及制品(十类)	其它纸及制品
空调外机	机械设备、电器	电力设备、电器机械及器材	家用电器
花卉营养液	农、林、牧、渔业产品	竹、木、藤、花、草	花草
贵宾郎酒	轻工、医药产品	饮食品	酒（白酒、啤酒、果酒类）
郎牌特曲	轻工、医药产品	饮食品	酒（白酒、啤酒、果酒类）
郎牌原浆	轻工、医药产品	饮食品	酒（白酒、啤酒、果酒类）
酒矿泉水	轻工、医药产品	饮食品	饮料、果菜汁
百威度纸箱听装	轻工、医药产品	纸及制品(十类)	其它
热镀加焊管发治	钢铁	钢 材、合金钢材	管材及附件
高白胶板印刷纸	轻工、医药产品	纸及制品(十类)	机制纸（新闻纸）
全轻型胶版纸	轻工、医药产品	纸及制品(十类)	纸板（原纸）
千百知饮料	轻工、医药产品	饮食品	饮料、果菜汁
灯	轻工、医药产品	日用工业品	灯具、照明装置、发光标志、牌照
灯饰	轻工、医药产品	日用工业品	灯具、照明装置、发光标志、牌照
墙纸	轻工、医药产品	纸及制品(十类)	其它纸及制品
布匹	轻工、医药产品	针织、纺织、皮毛及制品	布匹（机织、绒织、网织物、纱罗）
面煤	煤炭及制品	原煤	无烟煤
原煤	煤炭及制品	原煤	烟煤
钢支撑	钢铁	钢铁制品	电子、光、磁、超声波装置的元器件、零件、附件
黑矿	金属矿石	钢 材、合金钢材	其它
焦粉	金属矿石	铁矿石	其它
托克粉	农、林、牧、渔业产品	畜、禽、兽及制品	畜、禽、兽肉及制品
粉煤灰	煤炭及制品	原煤	无烟煤
煤泥	煤炭及制品	原煤	无烟煤
沥青	轻工、医药产品	针织、纺织、皮毛及制品	其它
澳粉	金属矿石	铁矿石	其它
1号原煤	煤炭及制品	生铁、铁合金、非合金钢	铁或非合金钢板轧材、卷、角、型材
董家口万里通德龙巴粗粉	轻工、医药产品	日用工业品	针织、纺织制品
董家口流畅永洋PB粉	轻工、医药产品	纸及制品(十类)	针织、纺织制品
德龙托克粉	其它货类	石料及石制品	雕塑、刻、漆工艺品
德晟PB块矿2018094	金属矿石	非金属矿、石、砂	磷矿石
曹妃甸澳森宝钢精神BRBF粉	轻工、医药产品	杂粮	其它未列名饮食及调味食品
混末	轻工、医药产品	针织、纺织、皮毛及制品	其它
焦粒	农、林、牧、渔业产品	经济作物及制品	动植物食用油料、脂肪及制品
锰硅合金	钢铁	生铁、铁合金、非合金钢	铁合金
蒙煤	煤炭及制品	原煤	烟煤
碱石	其它货类	其它未列名非金属矿石	其它
混煤	煤炭及制品	原煤	烟煤
蒙古煤	煤炭及制品	原煤	烟煤
铜杆	钢铁	钢 材、合金钢材	型材
氧化铁	钢铁	生铁、铁合金、非合金钢	板材
纸箱纸板	轻工、医药产品	纸及制品(十类)	纸板（原纸）
聚乙烯	轻工、医药产品	针织、纺织、皮毛及制品	服装
电解铜	机械设备、电器	电子、电讯设备及器材	通用设备
顺丰快递	轻工、医药产品	日用工业品	酒（白酒、啤酒、果酒类）
混沫	轻工、医药产品	针织、纺织、皮毛及制品	其它
耐火料	轻工、医药产品	其它未列名化工原料及制品	合成橡胶
矿石	金属矿石	铁矿石	其它
方钢	钢铁	钢 材、合金钢材	条、杆、角、网、栅、丝材
籽煤	煤炭及制品	原煤	烟煤
库瑞亚澳块	轻工、医药产品	饮食品	其它未列名饮食及调味食品
黄骅德龙奥块	钢铁	钢 材、合金钢材	管材及附件
切片	轻工、医药产品	饮食品	罐头，硬、软包装食品
昌顺精煤澳森	钢铁	钢 材、合金钢材	铁合金
矩形孔	有色金属	钢 材、合金钢材	管材及附件
天津超特粉	金属矿石	铁矿石	其它
前湾港万里通PB粉	农、林、牧、渔业产品	工艺美术品	雕塑、刻、漆工艺品
德盛海01-马来矿	金属矿石	铁矿石	其它
铝杆	有色金属	铝	精铝及铝材
钢线	钢铁	钢 材、合金钢材	线材
南粉41.37	金属矿石	铁矿石	其它
腾邑精煤澳森	煤炭及制品	原煤	无烟煤
废矾土	有色金属	铜	铝制品
格力配件	机械设备、电器	电力设备、电器机械及器材	家用电器
线材圆盘条	钢铁	钢 材、合金钢材	线材
镍矿	金属矿石	铬矿石	其它
澳森黄骅港中华和谐卡粉	金属矿石	铁矿石	其它
南飞原矿41.45	金属矿石	铁矿石	其它
南粉40.6	金属矿石	铁矿石	其它
泰拉煤	钢铁	原煤	精铝及铝材
土粉46.75	金属矿石	镍矿石	其它
南粉44.66	金属矿石	铁矿石	其它
黄骅德龙金布巴粉	钢铁	钢 材、合金钢材	管材及附件
克罗斯76澳块	金属矿石	铁矿石	其它
海阳002  马来矿	钢铁	钢 材、合金钢材	管材及附件
明泰煤	钢铁	生铁、铁合金、非合金钢	铁或非合金钢板轧材、卷、角、型材
伊朗块38.98	轻工、医药产品	饮食品	蔬菜
生石灰	轻工、医药产品	饮食品	雕塑、刻、漆工艺品
钢轨	钢铁	钢铁制品	铸、锻钢材
德晟巴西粗粉2018085	金属矿石	铁矿石	其它
格雷斯	轻工、医药产品	日用工业品	家具、坐具
华鑫焦粉澳森	农、林、牧、渔业产品	面粉	动植物食用油料、脂肪及制品
铝矿石	金属矿石	铁矿石	其它
原煤欧斯克A煤	煤炭及制品	原煤	烟煤
混麸	轻工、医药产品	针织、纺织、皮毛及制品	其它
聚乙烯704235B	轻工、医药产品	针织、纺织、皮毛及制品	服装
南粉41.89	金属矿石	铁矿石	其它
PB粉	金属矿石	铁矿石	其它
伊朗块42.29	轻工、医药产品	饮食品	蔬菜
顺意镍矿	轻工、医药产品	饮食品	茶叶、咖啡、可可（豆、粉）
扁锭	钢铁	钢铁制品	管材及附件
金昌焦炭奥森	轻工、医药产品	纸及制品(十类)	其它工艺美术品
均化料	轻工、医药产品	日用化工品	其它
南粉40.48	金属矿石	铁矿石	其它
白鹭至定边采油厂面煤	轻工、医药产品	饮食品	其它未列名饮食及调味食品
卷	轻工、医药产品	畜、禽、兽及制品	动植物食用油料、脂肪及制品
日照港龙安德龙巴西粗粉	机械设备、电器	专用机械、设备及制品	电子、光、磁、超声波装置的元器件、零件、附件
三阳焦粉	钢铁	钢 材、合金钢材	管材及附件
电工圆铝杆	轻工、医药产品	纸及制品(十类)	其它
富皇水泥煤炭	其它货类	工艺美术品	其它
富锰渣	金属矿石	铁矿石	其它
格雷斯混合粉	轻工、医药产品	日用工业品	家具、坐具
津巴布韦粉49.67	金属矿石	铁矿石	其它
猎鹰信心	机械设备、电器	钢铁制品	电工器材
南粉40.29％	金属矿石	铁矿石	其它
前湾港流畅永洋PB粉	农、林、牧、渔业产品	竹、木、藤、花、草	其它
蛋白粉	轻工、医药产品	饮食品	其它未列名饮食及调味食品
马粉46.86	轻工、医药产品	其它	其它
代县聚星烧结粉	轻工、医药产品	饮食品	其它未列名饮食及调味食品
铁矿石茶花梦	金属矿石	铁矿石	其它
董家口万里通德龙混合粉	轻工、医药产品	日用工业品	针织、纺织制品
钢材钢卷	钢铁	钢 材、合金钢材	卷材
圆钢汽运	钢铁	钢 材、合金钢材	线材
巴块30.76	金属矿石	铁矿石	其它
焦渣	农、林、牧、渔业产品	经济作物及制品	动植物食用油料、脂肪及制品
三阳焦粉澳森	钢铁	钢 材、合金钢材	管材及附件
日照龙安德龙PB块	机械设备、电器	钢铁制品	电工器材
土粉46.68	金属矿石	镍矿石	其它
大佛寺小块	机械设备、电器	专用机械、设备及制品	其它
合金锭	机械设备、电器	钢铁制品	美容化妆品
零担	轻工、医药产品	钢铁制品	锅炉、发动机 动力装置及辅助设备
董家口流畅德龙混合粉	轻工、医药产品	纸及制品(十类)	针织、纺织制品
土粉43.36	金属矿石	镍矿石	其它
巴块27.38	金属矿石	铁矿石	其它
南粉40.31	金属矿石	铁矿石	其它
商都南粉40.29	其它货类	饮食品	其它未列名饮食及调味食品
土粉46.97	金属矿石	镍矿石	其它
土粉47.54	金属矿石	镍矿石	其它
巴块30.47％	金属矿石	铁矿石	其它
巴块30.89％	金属矿石	铁矿石	其它
3266/南非高铁	金属矿石	铁矿石	其它
土粉46.95	金属矿石	镍矿石	其它
阿巴块32.84	金属矿石	铁矿石	其它
FMG筛后块	轻工、医药产品	饮食品	蔬菜
巴块30.47	金属矿石	铁矿石	其它
华顺铜精粉	有色金属	铜	雕塑、刻、漆工艺品
铁矿砂库克轮	金属矿石	铁矿石	其它
澳森黄骅艾瑞妮罗伊山块	金属矿石	铁矿石	其它
海阳马来矿	钢铁	钢 材、合金钢材	管材及附件
土粉48.53	金属矿石	镍矿石	其它
3266/92箱/南非高铁	化工原料及制品	其它未列名化工原料及制品	其它运输辅件及器材
糊树脂	轻工、医药产品	竹、木、藤、花、草	树木
净水剂	化工原料及制品	其它未列名化工原料及制品	其它
巴块32.94	金属矿石	铁矿石	其它
南粉44.21	金属矿石	铁矿石	其它
配货	钢铁	电子、电讯设备及器材	电子、光、磁、超声波装置的元器件、零件、附件
商都马粉46.86	轻工、医药产品	饮食品	乳制品，蜂蜜、王浆、粉
国新联程煤炭	钢铁	钢铁制品	管材及附件
41.89％南粉	金属矿石	铁矿石	其它
南粉45.06	金属矿石	铁矿石	其它
天宝铁粉	金属矿石	铁矿石	其它
铁矿砂库克2	金属矿石	铁矿石	其它
伊朗块29.16	轻工、医药产品	饮食品	蔬菜
玉米	金属矿石	铁矿石	其它
百货SCY	机械设备、电器	普通工业机械及设备	电子、光、磁、超声波装置的元器件、零件、附件
吨包袋	轻工、医药产品	纸及制品(十类)	其它
粉煤	煤炭及制品	原煤	无烟煤
津巴布韦粉49.9	金属矿石	铁矿石	其它
京城铁粉	钢铁	铁矿石	其它
南粉41.9	金属矿石	铁矿石	其它
水洗i煤	矿物性建筑材料	钢铁制品	其它
土粉45.6	金属矿石	镍矿石	其它
乌沫	轻工、医药产品	针织、纺织、皮毛及制品	其它
玉米淀粉	轻工、医药产品	饮食品	糕点、面食、谷物食品
众煜达	轻工、医药产品	针织、纺织、皮毛及制品	服装
道恩	农、林、牧、渔业产品	经济作物及制品	其它
吉利刚塑	轻工、医药产品	工艺美术品	其它
金鸡滩煤	煤炭及制品	原煤	其它
块煤	煤炭及制品	原煤	无烟煤
南非高铁	金属矿石	铁矿石	其它
140克精品牛皮纸	轻工、医药产品	纸及制品(十类)	纸制品
巴块30.6	金属矿石	铁矿石	其它
电力杆	机械设备、电器	电力设备、电器机械及器材	电工器材
海荣1   高铁	金属矿石	铁矿石	其它
南粉40.2	金属矿石	铁矿石	其它
土粉42.46	金属矿石	镍矿石	其它
魏墙至靖边采油厂沫煤	轻工、医药产品	工艺美术品	纸浆
伊朗39.16	轻工、医药产品	针织、纺织、皮毛及制品	其它
原	轻工、医药产品	竹、木、藤、花、草	其它
得信邦盐井煤炭	轻工、医药产品	日用工业品	其它纸及制品
德晟巴西粗粉	金属矿石	铁矿石	其它
鸿业华蓥煤炭	钢铁	钢 材、合金钢材	铁或非合金钢板轧材、卷、角、型材
货物	钢铁	钢铁制品	其它
南粉39.91	金属矿石	铁矿石	其它
塔斯曼	轻工、医药产品	饮食品	酒（白酒、啤酒、果酒类）
外货	钢铁	钢铁制品	钢铁件及其它五金制品
鑫洋精煤澳森	煤炭及制品	原煤	无烟煤
澳森曹妃甸宝钢精神BRBF粉	金属矿石	铁矿石	其它
伊朗块36.3	轻工、医药产品	饮食品	蔬菜
阿曼粉矿	金属矿石	铁矿石	其它
合川得信邦煤炭	机械设备、电器	电力设备、电器机械及器材	电工器材
兰炭面	轻工、医药产品	文化体育用品	糕点、面食、谷物食品
南粉40.49	金属矿石	铁矿石	其它
阳极	轻工、医药产品	其它	其它运输辅件及器材
弗吉尼亚1-南非块	轻工、医药产品	工艺美术品	雕塑、刻、漆工艺品
久安精煤澳森	钢铁	钢 材、合金钢材	铁或非合金钢板轧材、卷、角、型材
颗粒	轻工、医药产品	针织、纺织、皮毛及制品	其它
南粉44.49	金属矿石	铁矿石	其它
南粉45.02	金属矿石	铁矿石	其它
油渣	轻工、医药产品	日用工业品	钢铁容器
进钰祥	轻工、医药产品	针织、纺织、皮毛及制品	服装
三汇得信邦小块	钢铁	钢铁制品	钢铁件及其它五金制品
土粉46.9	金属矿石	镍矿石	其它
超源精煤澳森	钢铁	铁矿石	铁或非合金钢板轧材、卷、角、型材
峰沫	轻工、医药产品	针织、纺织、皮毛及制品	其它
库佳/南非高铁	轻工、医药产品	文化体育用品	其它
如隆带钢	钢铁	钢铁制品	钢铁件及其它五金制品
安泰焦炭澳森	其它货类	纸及制品(十类)	其它
棒材汽运一车按30吨计算	钢铁	钢 材、合金钢材	带材
天池宏丰煤炭	机械设备、电器	焦炭	生铁
铁矿	金属矿石	铁矿石	其它
阿巴块32.84％	金属矿石	铁矿石	其它
澳森黄骅银河BRBF粉	金属矿石	铁矿石	其它
包芯线	钢铁	钢铁制品	美容化妆品
国新联程小块	钢铁	钢铁制品	管材及附件
横梁	钢铁	钢 材、合金钢材	管材及附件
汇刚湿煤泥	钢铁	钢 材、合金钢材	钢铁件及其它五金制品
森鼎精煤澳森	煤炭及制品	原煤	无烟煤
铜管	钢铁	钢 材、合金钢材	管材及附件
原原	轻工、医药产品	饮食品	其它
阿曼籽矿	金属矿石	铁矿石	其它
巴块29.97	金属矿石	铁矿石	其它
百货	机械设备、电器	普通工业机械及设备	电子、光、磁、超声波装置的元器件、零件、附件
钣金	钢铁	钢铁制品	美容化妆品
海阳/马来矿	钢铁	钢 材、合金钢材	管材及附件
库佳3   南非高铁	轻工、医药产品	日用工业品	家具、坐具
煤（神木龙华D岢岚站台）	钢铁	钢铁制品	铁合金
七山煤	煤炭及制品	原煤	烟煤
三盛焦炭澳森	其它货类	纸及制品(十类)	纸浆
顺丰速运	机械设备、电器	工艺美术品	雕塑、刻、漆工艺品
碳粉	轻工、医药产品	面粉	糕点、面食、谷物食品
土粉31.14	金属矿石	镍矿石	其它
冷柜	钢铁	钢铁制品	钢铁容器
螺纹国润	钢铁	钢铁制品	线材
模具	轻工、医药产品	文化体育用品	文教办公用品
南非籽	钢铁	交通运输设备	其它
农贸辅料	轻工、医药产品	日用化工品	树木
医药设备	机械设备、电器	专用机械、设备及制品	医疗器械（具）、设备
不锈卷	轻工、医药产品	畜、禽、兽及制品	印刷品
镀锌槽钢	钢铁	钢 材、合金钢材	型材
鸿业华蓥溪口煤炭	钢铁	钢 材、合金钢材	铁或非合金钢板轧材、卷、角、型材
焦煤混煤	煤炭及制品	原煤	烟煤
京城到宏兴铁粉	钢铁	钢 材、合金钢材	型材
铝卷SSH	有色金属	铝	精铝及铝材
铝型材	有色金属	铝	其它运输辅件及器材
模板LYX	钢铁	钢 材、合金钢材	板材
模版LYX	轻工、医药产品	纸及制品(十类)	其它纸及制品
热轧圆钢20CrMoHK汽运	钢铁	钢 材、合金钢材	线材
橡胶（箱）	化工原料及制品	橡胶	普通金属工艺品
一三籽煤	钢铁	原煤	精铝及铝材
圆管	钢铁	钢 材、合金钢材	管材及附件
25kg小苏打轻碱	钢铁	钢 材、合金钢材	板材
58克轻质轻量涂布纸	轻工、医药产品	纸及制品(十类)	机制纸（新闻纸）
77克精品牛皮纸	轻工、医药产品	纸及制品(十类)	纸制品
HRRHWR占百分之20综合报价	轻工、医药产品	饮食品	其它未列名饮食及调味食品
富皇水泥末煤	其它货类	工艺美术品	其它
刚支撑	轻工、医药产品	针织、纺织、皮毛及制品	纸浆
钢材钢材()钢材，刘	钢铁	钢 材、合金钢材	型材
钢支撑、钢围檩	钢铁	钢铁制品	管材及附件
火车篷布	轻工、医药产品	针织、纺织、皮毛及制品	文教办公用品
精品牛皮纸	轻工、医药产品	纸及制品(十类)	纸制品
聚乙烯222	轻工、医药产品	针织、纺织、皮毛及制品	服装
磷铁	钢铁	生铁、铁合金、非合金钢	铁合金
绿叶浆江河	轻工、医药产品	纸及制品(十类)	纸浆
耐材豫J41489	机械设备、电器	日用化工品	卫生品(洗涤剂、皂类)
牛皮	农、林、牧、渔业产品	畜、禽、兽及制品	动物生皮、毛、骨（粉）
啤酒1	轻工、医药产品	饮食品	酒（白酒、啤酒、果酒类）
栖霞煤炭	其它货类	杂粮	雕塑、刻、漆工艺品
三才～昶通块煤～001	其它货类	各种废旧物品	其它
神马化肥	轻工、医药产品	工艺美术品	其它未列名饮食及调味食品
石板	钢铁	钢 材、合金钢材	板材
碳灰	轻工、医药产品	饮食品	糖果、蜜饯、果脯
碳酸锂	轻工、医药产品	日用工业品	酒（白酒、啤酒、果酒类）
铁矿砂20180316欧梅	金属矿石	铁矿石	其它
王米淀粉	农、林、牧、渔业产品	饮食品	动植物食用油料、脂肪及制品
洗中块	机械设备、电器	电力设备、电器机械及器材	电工器材
锌钢管材	钢铁	钢 材、合金钢材	管材及附件
旋灰块不过筛	轻工、医药产品	针织、纺织、皮毛及制品	其它未列名针织、纺织、皮革及制品
孕育剂	化工原料及制品	其它未列名化工原料及制品	其它
苏氨酸	钢铁	钢 材、合金钢材	管材及附件
球化剂	钢铁	工艺美术品	钢铁件及其它五金制品
70克精品牛皮纸	轻工、医药产品	纸及制品(十类)	纸制品
80克精品牛皮纸	轻工、医药产品	纸及制品(十类)	纸制品
85M10T	轻工、医药产品	竹、木、藤、花、草	陶瓷制品
LC-3AB后门内板	钢铁	钢 材、合金钢材	板材
电缆桥架	机械设备、电器	钢铁制品	钢铁材料、结构体
弗吉尼亚2-南非块	轻工、医药产品	工艺美术品	雕塑、刻、漆工艺品
钢材镀锌卷	钢铁	钢 材、合金钢材	管材及附件
光缆接头盒	机械设备、电器	电力设备、电器机械及器材	电工器材
加气块	其它货类	其它	其它
嘉吉PB粉56949	金属矿石	钢 材、合金钢材	管材及附件
金鱼浆	轻工、医药产品	纸及制品(十类)	纸浆
聚甲醛	轻工、医药产品	针织、纺织、皮毛及制品	服装
聚乙烯1	轻工、医药产品	针织、纺织、皮毛及制品	服装
聚乙烯64M40T	轻工、医药产品	针织、纺织、皮毛及制品	服装
兰炭运费	轻工、医药产品	饮食品	其它未列名饮食及调味食品
煤矿	金属矿石	其它未列名金属矿及砂、灰、渣	其它
米糠粕	农、林、牧、渔业产品	经济作物及制品	经济作物原料、残渣及副产品
米石	其它货类	其它	其它
耐材	轻工、医药产品	文化体育用品	其它
南非南铁	金属矿石	铁矿石	其它
南粉42.11	金属矿石	铁矿石	其它
瓶胚	轻工、医药产品	针织、纺织、皮毛及制品	皮毛制品
迁安黑方钢管	钢铁	钢 材、合金钢材	管材及附件
迁安热热镀钢管	钢铁	钢 材、合金钢材	管材及附件
石灰块	轻工、医药产品	其它	雕塑、刻、漆工艺品
饲料添加剂	轻工、医药产品	饮食品	畜、禽、兽肉及制品
铁托盘	钢铁	生铁、铁合金、非合金钢	铁合金
土粉47.25	金属矿石	镍矿石	其它
脱脂槽	钢铁	钢 材、合金钢材	型材
脱脂槽设备	钢铁	钢 材、合金钢材	型材
永洋钢轨	钢铁	钢铁制品	条、杆、角、网、栅、丝材
预埋件	机械设备、电器	交通运输设备	其它运输辅件及器材
制动器	机械设备、电器	普通工业机械及设备	通用零部件
中石化管道	钢铁	钢 材、合金钢材	管材及附件
重轨	机械设备、电器	交通运输设备	其它运输辅件及器材
140克牛皮纸	轻工、医药产品	纸及制品(十类)	其它纸及制品
143克精品牛皮纸	轻工、医药产品	纸及制品(十类)	纸制品
赖氨酸	钢铁	钢 材、合金钢材	板材
64M40T	轻工、医药产品	竹、木、藤、花、草	陶瓷制品
68克精品牛皮纸	轻工、医药产品	纸及制品(十类)	纸制品
75克高强度纸袋纸	化工原料及制品	各种废旧物品	其它
78克精品牛皮纸	轻工、医药产品	纸及制品(十类)	纸制品
背门内板	钢铁	钢 材、合金钢材	板材
巴块30.79	金属矿石	铁矿石	其它
巴西精粉	金属矿石	铁矿石	其它
丙二醇	轻工、医药产品	针织、纺织、皮毛及制品	服装
彩钢卷	钢铁	钢 材、合金钢材	卷材
成品车	机械设备、电器	其它	其它
厨房用品	轻工、医药产品	日用工业品	卫生品(洗涤剂、皂类)
粗锌	钢铁	钢 材、合金钢材	管材及附件
德晟PB块矿	金属矿石	非金属矿、石、砂	磷矿石
冻货	钢铁	钢 材、合金钢材	管材及附件
吨块	钢铁	钢 材、合金钢材	管材及附件
多孔码	轻工、医药产品	针织、纺织、皮毛及制品	服装
发动机配件	机械设备、电器	钢 材、合金钢材	管材及附件
钢球	钢铁	钢 材、合金钢材	铸、锻钢材
钢围檩	机械设备、电器	日用化工品	电工器材
钢支撑钢围檩	钢铁	钢铁制品	管材及附件
格力模具	轻工、医药产品	电力设备、电器机械及器材	家具、坐具
工字钢角钢	钢铁	钢 材、合金钢材	型材
光缆终端盒	机械设备、电器	电子、电讯设备及器材	电子、光、磁、超声波装置的元器件、零件、附件
硅铁33	钢铁	生铁、铁合金、非合金钢	铁合金
硅铁34	钢铁	生铁、铁合金、非合金钢	铁合金
架子扣	轻工、医药产品	日用工业品	其它日用品
江油洗小块	机械设备、电器	普通工业机械及设备	金属加工机械及设备
接头盒	轻工、医药产品	针织、纺织、皮毛及制品	服装
金鸡滩	农、林、牧、渔业产品	经济作物及制品	动植物食用油料、脂肪及制品
聚丙烯颗粒	轻工、医药产品	工艺美术品	纸浆
铝管	钢铁	钢 材、合金钢材	铁或非合金钢板轧材、卷、角、型材
铝合金SSH	有色金属	铝	铝制品
煤碳	煤炭及制品	原煤	烟煤
镁锭	轻工、医药产品	针织、纺织、皮毛及制品	其它
面粉小包装头道粉	轻工、医药产品	纸及制品(十类)	糕点、面食、谷物食品
模具设备	机械设备、电器	专用机械、设备及制品	其它日用品
磨具	轻工、医药产品	文化体育用品	文教办公用品
木板	轻工、医药产品	纸及制品(十类)	其它
南非高硫粉41.31	轻工、医药产品	工艺美术品	树木
热轧卷板	钢铁	钢 材、合金钢材	板材
硅锰合金	钢铁	生铁、铁合金、非合金钢	铁合金
砂加气砖	金属矿石	铁矿石	其它
土粉47.58	金属矿石	镍矿石	其它
味素	农、林、牧、渔业产品	畜、禽、兽及制品	动植物食用油料、脂肪及制品
姚家钢卷	钢铁	钢 材、合金钢材	管材及附件
宜家科勒洁具	轻工、医药产品	文化体育用品	家具、坐具
银金达薄膜	机械设备、电器	铜	其它
永洋工型钢	轻工、医药产品	纸及制品(十类)	家具、坐具
运动器材	机械设备、电器	普通工业机械及设备	通用零部件
纸板	轻工、医药产品	纸及制品(十类)	其它纸及制品
指示牌	农、林、牧、渔业产品	畜、禽、兽及制品	烟叶、烟草、卷烟、雪茄及代用品
惠美佳400g味精	轻工、医药产品	饮食品	其它未列名饮食及调味食品
金鼎小札浓香菜籽油5L	农、林、牧、渔业产品	经济作物及制品	动植物食用油料、脂肪及制品
金鼎纯香菜籽油5L	农、林、牧、渔业产品	经济作物及制品	动植物食用油料、脂肪及制品
卷板Q235B	钢铁	钢 材、合金钢材	卷材
盘螺14	钢铁	钢 材、合金钢材	线材
线材8	钢铁	钢 材、合金钢材	线材
8三级盘螺	钢铁	钢 材、合金钢材	线材
盘螺6	钢铁	钢 材、合金钢材	线材
硅钢管	钢铁	钢 材、合金钢材	管材及附件
卡槽卡簧	钢铁	钢 材、合金钢材	型材
元冠白砂糖	轻工、医药产品	饮食品	糖（固体、浆）
60克胶版印刷纸	轻工、医药产品	纸及制品(十类)	机制纸（新闻纸）
H型钢400x400	钢铁	钢 材、合金钢材	型材
H型钢582x300	钢铁	钢 材、合金钢材	型材
钢支架槽钢钢立柱	钢铁	钢铁制品	钢铁材料、结构体
镀锌方管	钢铁	钢 材、合金钢材	管材及附件
槽钢扁铁	钢铁	钢 材、合金钢材	型材
80克全木浆复印纸	轻工、医药产品	纸及制品(十类)	机制纸（新闻纸）
起重行车	机械设备、电器	交通运输设备	道路机动车辆
护栏板方管	钢铁	钢 材、合金钢材	管材及附件
钢塑管	钢铁	钢 材、合金钢材	管材及附件
90克全木浆胶版纸	轻工、医药产品	纸及制品(十类)	纸板（原纸）
电器外壳	机械设备、电器	电力设备、电器机械及器材	家用电器
转向架	钢铁	钢铁制品	钢铁件及其它五金制品
办公凳子 20*20*20  7	轻工、医药产品	日用工业品	家具、坐具
办公椅 20*20*20  7	轻工、医药产品	日用工业品	家具、坐具
办公桌 1.4*2M 8	轻工、医药产品	日用工业品	家具、坐具
床 20*20*20  7	轻工、医药产品	日用工业品	家具、坐具
床头 20*20*20  7	轻工、医药产品	日用工业品	家具、坐具
热轧钢板有超宽水运询价	钢铁	钢 材、合金钢材	板材
管坯钢	钢铁	钢 材、合金钢材	型材
热轧钢板船运有超宽板	钢铁	钢 材、合金钢材	板材
热轧线材汽运	钢铁	钢 材、合金钢材	卷材
纸桨	轻工、医药产品	纸及制品(十类)	纸浆
一水糖	轻工、医药产品	饮食品	糖（固体、浆）
无水糖	轻工、医药产品	饮食品	糖（固体、浆）
铁矿粉	金属矿石	铁矿石	其它
玻纤纱	轻工、医药产品	针织、纺织、皮毛及制品	纱、线、丝、纤维（非复合材料）
糊精	轻工、医药产品	饮食品	文教办公用品
网格布	钢铁	钢铁制品	钢铁件及其它五金制品
尼龙	轻工、医药产品	针织、纺织、皮毛及制品	纺织材料包、套等，复合材料纱、线、绳
原料味精25KG	轻工、医药产品	饮食品	其它未列名饮食及调味食品
镀锌产品黑方管	钢铁	钢 材、合金钢材	管材及附件
热轧钢板汽运仔细看备注	钢铁	钢 材、合金钢材	板材
方管管	钢铁	钢 材、合金钢材	管材及附件
拖鞋	轻工、医药产品	针织、纺织、皮毛及制品	鞋帽
金鼎食用调和油	农、林、牧、渔业产品	经济作物及制品	动植物食用油料、脂肪及制品
金鼎纯正菜籽油	农、林、牧、渔业产品	经济作物及制品	动植物食用油料、脂肪及制品
试卷	轻工、医药产品	文化体育用品	布匹（机织、绒织、网织物、纱罗）
铝板	有色金属	铝	精铝及铝材
家具	轻工、医药产品	日用工业品	家具、坐具
家居	轻工、医药产品	日用工业品	家具、坐具
镀锌卷	钢铁	钢 材、合金钢材	卷材
黑方管制品	钢铁	钢 材、合金钢材	管材及附件
王老吉饮料	轻工、医药产品	饮食品	饮料、果菜汁
展示柜	轻工、医药产品	其它未列名化工原料及制品	其它
角钢方管	钢铁	钢 材、合金钢材	管材及附件
铸管	钢铁	钢 材、合金钢材	管材及附件
铁芯	钢铁	生铁、铁合金、非合金钢	铁合金
铁塔件	钢铁	生铁、铁合金、非合金钢	铁或非合金钢板轧材、卷、角、型材
彩钢瓦	钢铁	钢铁制品	条、杆、角、网、栅、丝材
型材	钢铁	钢 材、合金钢材	型材
电梯配件	机械设备、电器	普通工业机械及设备	通用设备
钢管加螺旋管	钢铁	钢 材、合金钢材	管材及附件
焊管加螺旋管	钢铁	钢铁制品	钢铁件及其它五金制品
焊方管	钢铁	钢 材、合金钢材	管材及附件
方管加镀方管	钢铁	钢 材、合金钢材	管材及附件
方距管	钢铁	钢 材、合金钢材	管材及附件
电柜	其它货类	电力设备、电器机械及器材	家用电器
镀锡角钢	钢铁	钢 材、合金钢材	型材
方钜管	钢铁	钢 材、合金钢材	管材及附件
铜	有色金属	铜	铜型、线材、异型材及附件
氨纶	轻工、医药产品	针织、纺织、皮毛及制品	其它
人棉纱	轻工、医药产品	针织、纺织、皮毛及制品	布匹（机织、绒织、网织物、纱罗）
人造丝	轻工、医药产品	针织、纺织、皮毛及制品	布匹（机织、绒织、网织物、纱罗）
绣花线	钢铁	钢 材、合金钢材	钢铁容器
缝纫线	轻工、医药产品	针织、纺织、皮毛及制品	纱、线、丝、纤维（非复合材料）
调味品	轻工、医药产品	饮食品	其它未列名饮食及调味食品
78克薄本纸	轻工、医药产品	纸及制品(十类)	其它纸及制品
电器	机械设备、电器	电力设备、电器机械及器材	家用电器
钢丝	钢铁	钢铁制品	钢铁材料、结构体
无纺布	轻工、医药产品	针织、纺织、皮毛及制品	其它未列名针织、纺织、皮革及制品
铸件	钢铁	钢 材、合金钢材	铸、锻钢材
布	轻工、医药产品	针织、纺织、皮毛及制品	布匹（机织、绒织、网织物、纱罗）
辅料	轻工、医药产品	针织、纺织、皮毛及制品	其它
铁件	钢铁	生铁、铁合金、非合金钢	铁或非合金钢板轧材、卷、角、型材
热轧钢板汽运	钢铁	钢 材、合金钢材	板材
凌雪白砂糖	轻工、医药产品	饮食品	糖（固体、浆）
空调	机械设备、电器	电力设备、电器机械及器材	家用电器
焊管螺旋管	钢铁	钢 材、合金钢材	管材及附件
热镀管钢塑管	钢铁	钢 材、合金钢材	管材及附件
美的电器	机械设备、电器	电力设备、电器机械及器材	家用电器
齿轮钢	钢铁	钢 材、合金钢材	型材
内胎	其它货类	橡胶	橡胶制品
PC160907000056空调	机械设备、电器	电力设备、电器机械及器材	家用电器
PC160910000060纸	轻工、医药产品	纸及制品(十类)	其它纸及制品
PC160911000034空调	机械设备、电器	电力设备、电器机械及器材	家用电器
PC160911000037空调	机械设备、电器	电力设备、电器机械及器材	家用电器
PC160911000031空调	机械设备、电器	电力设备、电器机械及器材	家用电器
PC160912000026型材	钢铁	钢 材、合金钢材	型材
PC160911000032空调	机械设备、电器	电力设备、电器机械及器材	家用电器
PC160912000087空调箔	机械设备、电器	电力设备、电器机械及器材	家用电器
PC160912000083空调箔	机械设备、电器	电力设备、电器机械及器材	家用电器
PC160911000027箔坯	有色金属	铝	精铝及铝材
PC160912000007小家电	机械设备、电器	电力设备、电器机械及器材	家用电器
PC160912000097纸	轻工、医药产品	纸及制品(十类)	其它纸及制品
PC160912000096纸	轻工、医药产品	纸及制品(十类)	其它纸及制品
PC160912000095纸	轻工、医药产品	纸及制品(十类)	其它纸及制品
PC160913000030纸	轻工、医药产品	纸及制品(十类)	其它纸及制品
PC160913000028纸	轻工、医药产品	纸及制品(十类)	其它纸及制品
PC160912000084空调	机械设备、电器	电力设备、电器机械及器材	家用电器
PC160913000029纸	轻工、医药产品	纸及制品(十类)	其它纸及制品
PC160913000088纸	轻工、医药产品	纸及制品(十类)	其它纸及制品
PC160911000030空调	机械设备、电器	电力设备、电器机械及器材	家用电器
PC160913000094格力电器	机械设备、电器	电力设备、电器机械及器材	家用电器
PC160913000119纸	轻工、医药产品	纸及制品(十类)	其它纸及制品
PC160913000033空调	机械设备、电器	电力设备、电器机械及器材	家用电器
PC160913000120纸	轻工、医药产品	纸及制品(十类)	其它纸及制品
PC160913000032空调	机械设备、电器	电力设备、电器机械及器材	家用电器
PC160913000038空调	机械设备、电器	电力设备、电器机械及器材	家用电器
PC160913000037空调	机械设备、电器	电力设备、电器机械及器材	家用电器
PC160913000034空调	机械设备、电器	电力设备、电器机械及器材	家用电器
PC160912000089空调	机械设备、电器	电力设备、电器机械及器材	家用电器
PC160912000088空调	机械设备、电器	电力设备、电器机械及器材	家用电器
PC160913000031空调	机械设备、电器	电力设备、电器机械及器材	家用电器
PC160913000035空调	机械设备、电器	电力设备、电器机械及器材	家用电器
PC160913000036空调	机械设备、电器	电力设备、电器机械及器材	家用电器
PC160913000125纸	轻工、医药产品	纸及制品(十类)	其它纸及制品
PC160914000004空调	机械设备、电器	电力设备、电器机械及器材	家用电器
PC160913000087白象方便面	轻工、医药产品	饮食品	糕点、面食、谷物食品
PC160913000122白象方便面	轻工、医药产品	饮食品	糕点、面食、谷物食品
PC160914000001白象方便面	轻工、医药产品	饮食品	糕点、面食、谷物食品
PC160914000003白象方便面	轻工、医药产品	饮食品	糕点、面食、谷物食品
PC160913000096白象方便面	轻工、医药产品	饮食品	糕点、面食、谷物食品
传动设备	机械设备、电器	普通工业机械及设备	通用设备
焊管33吨	钢铁	钢 材、合金钢材	管材及附件
热方35吨	钢铁	钢 材、合金钢材	管材及附件
70克全木浆胶版纸875	轻工、医药产品	纸及制品(十类)	纸板（原纸）
70克全木浆胶版纸875X1100	轻工、医药产品	纸及制品(十类)	纸板（原纸）
中板26	钢铁	钢 材、合金钢材	板材
中板32	钢铁	钢 材、合金钢材	板材
60克胶版印刷纸787X1092	轻工、医药产品	纸及制品(十类)	机制纸（新闻纸）
41克无碳复写原纸1560	轻工、医药产品	纸及制品(十类)	其它纸及制品
45克无碳复写原纸1035	轻工、医药产品	纸及制品(十类)	其它纸及制品
黑方加焊管11吨	钢铁	钢 材、合金钢材	管材及附件
58精制轻量涂布纸1095	轻工、医药产品	纸及制品(十类)	机制纸（新闻纸）
58克精制轻量涂布纸820	轻工、医药产品	纸及制品(十类)	机制纸（新闻纸）
方矩管+焊管	钢铁	钢 材、合金钢材	管材及附件
78克胶版印刷纸990	轻工、医药产品	纸及制品(十类)	机制纸（新闻纸）
68克胶版印刷纸740	轻工、医药产品	纸及制品(十类)	机制纸（新闻纸）
75克胶版印刷纸787X1092	轻工、医药产品	纸及制品(十类)	机制纸（新闻纸）
64克精制轻量涂布纸781	轻工、医药产品	纸及制品(十类)	机制纸（新闻纸）
热焊管	钢铁	钢 材、合金钢材	管材及附件
湿浆	轻工、医药产品	木浆	纸浆
80克象牙白道林纸1000X710	轻工、医药产品	纸及制品(十类)	机制纸（新闻纸）
100克象牙白道林纸1000X710	轻工、医药产品	纸及制品(十类)	机制纸（新闻纸）
70克象牙白道林纸889x1194	轻工、医药产品	纸及制品(十类)	机制纸（新闻纸）
100克象牙白道林纸889x1194	轻工、医药产品	纸及制品(十类)	机制纸（新闻纸）
120克象牙白道林纸787x1092	轻工、医药产品	纸及制品(十类)	机制纸（新闻纸）
100克象牙白道林纸787X1092	轻工、医药产品	纸及制品(十类)	机制纸（新闻纸）
焊管31T	钢铁	钢 材、合金钢材	管材及附件
棕榈仁粕	农、林、牧、渔业产品	经济作物及制品	经济作物原料、残渣及副产品
12x9m螺纹等	钢铁	钢 材、合金钢材	线材
12螺纹等	钢铁	钢 材、合金钢材	线材
纸盒	轻工、医药产品	纸及制品(十类)	其它纸及制品
低水泥浇注料	矿物性建筑材料	水泥制品	其它
行车	机械设备、电器	专用机械、设备及制品	重工业机械、工程机械及零件
薄本纸	轻工、医药产品	纸及制品(十类)	其它纸及制品
低压柜	其它货类	其它	其它
易拉罐	有色金属	铝	铜及铝合金制品
98克全木浆胶版纸889X1194	轻工、医药产品	纸及制品(十类)	纸板（原纸）
80克高松微涂纸780	轻工、医药产品	纸及制品(十类)	机制纸（新闻纸）
80克高松微涂纸787X1092	轻工、医药产品	纸及制品(十类)	机制纸（新闻纸）
废纸LMA	其它货类	各种废旧物品	其它
大理石PHJ	非金属矿石	石灰石	其它
废纸SJ	其它货类	各种废旧物品	其它
铁粉・	金属矿石	生铁、铁合金、非合金钢	其它
锅PHJ	轻工、医药产品	文化体育用品	文教办公用品
12石子	矿物性建筑材料	石料及石制品	其它
78克全木浆胶版纸787X1092	轻工、医药产品	纸及制品(十类)	纸板（原纸）
钢丝PHJ	钢铁	钢铁制品	钢铁材料、结构体
干辣椒	轻工、医药产品	饮食品	其它未列名饮食及调味食品
B钢	钢铁	钢 材、合金钢材	型材
牵引车头	机械设备、电器	专用机械、设备及制品	重工业机械、工程机械及零件
平板纸PHJ	轻工、医药产品	纸及制品(十类)	纸制品
成品平板80克精制轻量涂布纸787	轻工、医药产品	纸及制品(十类)	机制纸（新闻纸）
太阳能组件14	机械设备、电器	电子、电讯设备及器材	电池、蓄电池
太阳能组件15	机械设备、电器	电子、电讯设备及器材	电池、蓄电池
太阳能组件16	机械设备、电器	电子、电讯设备及器材	电池、蓄电池
太阳能组件17	机械设备、电器	电子、电讯设备及器材	电池、蓄电池
太阳能组件18	机械设备、电器	电子、电讯设备及器材	电池、蓄电池
太阳能组件	机械设备、电器	电子、电讯设备及器材	电池、蓄电池
焦面	粮食	面粉	其他加工麦粉粒
袋装玉米	轻工、医药产品	工艺美术品	雕塑、刻、漆工艺品
PC161031000047落地包装袋	化工原料及制品	纸及制品(十类)	其它
线材	钢铁	钢 材、合金钢材	线材
铁丝网	钢铁	钢铁制品	钢铁件及其它五金制品
豆类	粮食	杂粮	杂豆
保健品	轻工、医药产品	工艺美术品	雕塑、刻、漆工艺品
医疗器械	机械设备、电器	专用机械、设备及制品	医疗器械（具）、设备
无烟煤	煤炭及制品	原煤	无烟煤
轴承	机械设备、电器	普通工业机械及设备	通用零部件
液压阀	机械设备、电器	普通工业机械及设备	通用零部件
机床	机械设备、电器	普通工业机械及设备	金属加工机械及设备
破碎机	机械设备、电器	专用机械、设备及制品	重工业机械、工程机械及零件
弹簧	钢铁	钢铁制品	钢铁件及其它五金制品
网带	钢铁	钢铁制品	钢铁件及其它五金制品
螺母	钢铁	钢铁制品	钢铁件及其它五金制品
螺钉	钢铁	钢铁制品	钢铁件及其它五金制品
螺栓	钢铁	钢 材、合金钢材	线材
装载机	机械设备、电器	普通工业机械及设备	通用设备
振动筛	机械设备、电器	普通工业机械及设备	通用设备
卫衣	轻工、医药产品	针织、纺织、皮毛及制品	服装
裙装	轻工、医药产品	针织、纺织、皮毛及制品	服装
牛仔裤	轻工、医药产品	针织、纺织、皮毛及制品	服装
上衣	轻工、医药产品	针织、纺织、皮毛及制品	服装
女鞋	轻工、医药产品	针织、纺织、皮毛及制品	鞋帽
呢大衣	轻工、医药产品	针织、纺织、皮毛及制品	服装
背心连衣裙	轻工、医药产品	针织、纺织、皮毛及制品	服装
打底裤	轻工、医药产品	针织、纺织、皮毛及制品	服装
休闲裤	轻工、医药产品	针织、纺织、皮毛及制品	服装
双排扣大衣	轻工、医药产品	针织、纺织、皮毛及制品	服装
针织衫	轻工、医药产品	针织、纺织、皮毛及制品	针织、纺织制品
连衣裙	轻工、医药产品	针织、纺织、皮毛及制品	服装
餐椅	轻工、医药产品	日用工业品	家具、坐具
其他餐厅家具	轻工、医药产品	日用工业品	家具、坐具
学校家具	轻工、医药产品	日用工业品	家具、坐具
食堂餐桌	轻工、医药产品	日用工业品	家具、坐具
食堂餐椅	轻工、医药产品	日用工业品	家具、坐具
阅览室桌	轻工、医药产品	日用工业品	家具、坐具
阅览室椅	轻工、医药产品	日用工业品	家具、坐具
课桌椅	轻工、医药产品	日用工业品	家具、坐具
学生床	轻工、医药产品	日用工业品	家具、坐具
其他学校家具	轻工、医药产品	日用工业品	家具、坐具
户外家具	轻工、医药产品	日用工业品	家具、坐具
休闲桌	轻工、医药产品	日用工业品	家具、坐具
休闲椅	轻工、医药产品	日用工业品	家具、坐具
普板12	钢铁	钢 材、合金钢材	板材
普板4	钢铁	钢 材、合金钢材	板材
角钢	钢铁	钢 材、合金钢材	型材
普板	钢铁	钢 材、合金钢材	板材
开平花纹板	钢铁	钢 材、合金钢材	板材
酸洗大梁板	钢铁	钢 材、合金钢材	线材
5L浓香菜籽油	农、林、牧、渔业产品	经济作物及制品	动植物食用油料、脂肪及制品
5L葵花菜籽油	农、林、牧、渔业产品	经济作物及制品	动植物食用油料、脂肪及制品
18L浓香菜籽油	农、林、牧、渔业产品	经济作物及制品	动植物食用油料、脂肪及制品
5L纯香菜籽油	农、林、牧、渔业产品	经济作物及制品	动植物食用油料、脂肪及制品
板材(8-50)mm （1500-3270）mm （5000-12080）mm	钢铁	钢 材、合金钢材	板材
板材850mm15003270mm500012080mm	钢铁	钢 材、合金钢材	板材
钢板规格见备注	钢铁	钢 材、合金钢材	板材
钢板详细见备注	钢铁	钢 材、合金钢材	板材
开平钢板	钢铁	钢 材、合金钢材	板材
钢板详见备注	钢铁	钢 材、合金钢材	板材
镀锌管焊管	钢铁	钢 材、合金钢材	管材及附件
沙发 20*20*20  7	轻工、医药产品	日用工业品	家具、坐具
板材20*20*20  7	钢铁	钢 材、合金钢材	板材
糖	轻工、医药产品	饮食品	糖（固体、浆）
葡萄糖	轻工、医药产品	饮食品	糖（固体、浆）
板材汽运有超长超宽仔细看备注	钢铁	钢 材、合金钢材	板材
钢板汽运仔细看备注	钢铁	钢 材、合金钢材	板材
药用葡萄糖	轻工、医药产品	饮食品	酒（白酒、啤酒、果酒类）
船板汽运包车	钢铁	钢 材、合金钢材	板材
沪通长江大桥用Q345D钢板船运	钢铁	钢 材、合金钢材	板材
1.8米宽8米长开平板	钢铁	钢 材、合金钢材	板材
4.75mm开平板	钢铁	钢 材、合金钢材	板材
尼龙绳	轻工、医药产品	针织、纺织、皮毛及制品	布匹（机织、绒织、网织物、纱罗）
钢板15日出口集港	钢铁	钢铁制品	板材
罐头	轻工、医药产品	饮食品	罐头，硬、软包装食品
钢板汽运	钢铁	钢 材、合金钢材	板材
HPT钢板美标容器汽运有超宽	钢铁	钢 材、合金钢材	板材
钢板汽运有超长超宽	钢铁	钢 材、合金钢材	板材
PC161101000123洗碗机洗衣机	机械设备、电器	电力设备、电器机械及器材	家用电器
焊管加黑方31T发长垣	钢铁	钢 材、合金钢材	管材及附件
船板船运仔细看备注	钢铁	钢 材、合金钢材	板材
焊管加黑方发芜湖三山区	钢铁	钢 材、合金钢材	管材及附件
钢筋焊网	钢铁	钢铁制品	钢铁件及其它五金制品
焊管加黑方加热镀	钢铁	钢 材、合金钢材	管材及附件
新乡通宝焊管加热镀	钢铁	钢 材、合金钢材	管材及附件
太原恒帅焊管加热镀	钢铁	钢 材、合金钢材	管材及附件
发临汾焊管	钢铁	钢 材、合金钢材	管材及附件
发泰安焊管直属指定	钢铁	钢 材、合金钢材	管材及附件
发泰安焊管	钢铁	钢 材、合金钢材	管材及附件
焊管热镀指定	钢铁	钢 材、合金钢材	管材及附件
钢板汽运有超长超宽板请看清备注	钢铁	钢 材、合金钢材	板材
发洛阳焊管	钢铁	钢 材、合金钢材	管材及附件
焊管热镀苏州工业园指定	钢铁	钢 材、合金钢材	管材及附件
宝鸡市凯业焊管	钢铁	钢 材、合金钢材	管材及附件
补焊管32T发小店	钢铁	钢 材、合金钢材	管材及附件
70克高白胶版印刷纸	轻工、医药产品	纸及制品(十类)	机制纸（新闻纸）
75克高白胶版印刷纸889	轻工、医药产品	纸及制品(十类)	机制纸（新闻纸）
95克高白胶版印刷纸	轻工、医药产品	纸及制品(十类)	机制纸（新闻纸）
焊管或者热镀两票	钢铁	钢 材、合金钢材	管材及附件
热镀加焊管18T	钢铁	钢 材、合金钢材	管材及附件
角钢4#	钢铁	钢 材、合金钢材	型材
角钢6.3#	钢铁	钢 材、合金钢材	型材
济南1车焊管热镀焊管定尺6米9	钢铁	钢 材、合金钢材	管材及附件
55克高白胶版印刷纸1194X889	轻工、医药产品	纸及制品(十类)	机制纸（新闻纸）
68克高白胶版印刷纸770	轻工、医药产品	纸及制品(十类)	机制纸（新闻纸）
两票热镀焊管	钢铁	钢 材、合金钢材	管材及附件
80克高白胶版印刷纸1100	轻工、医药产品	纸及制品(十类)	机制纸（新闻纸）
98克高白胶版印刷纸1100	轻工、医药产品	纸及制品(十类)	机制纸（新闻纸）
郫县豆瓣	轻工、医药产品	饮食品	其它未列名饮食及调味食品
即墨+胶南两地卸焊管热镀	钢铁	钢 材、合金钢材	管材及附件
白方焊管发洛阳	钢铁	钢 材、合金钢材	管材及附件
58克高白胶版印刷纸880	轻工、医药产品	纸及制品(十类)	机制纸（新闻纸）
68克高白胶版印刷纸566	轻工、医药产品	纸及制品(十类)	机制纸（新闻纸）
热镀加焊管两磅	钢铁	钢 材、合金钢材	管材及附件
茶叶	轻工、医药产品	饮食品	茶叶、咖啡、可可（豆、粉）
焊管32到33T运费发到河南省南阳市内乡县五里堡坤源	钢铁	钢 材、合金钢材	管材及附件
热镀加焊管4寸7米定尺	钢铁	钢 材、合金钢材	管材及附件
65克高白胶版印刷纸889X1194	轻工、医药产品	纸及制品(十类)	机制纸（新闻纸）
65克高白胶版印刷纸787X1092	轻工、医药产品	纸及制品(十类)	机制纸（新闻纸）
58克高白胶版印刷纸889X1194	轻工、医药产品	纸及制品(十类)	机制纸（新闻纸）
焊管44T运费90一票制发洛阳联	钢铁	钢 材、合金钢材	管材及附件
合肥宝光当涂县两车热镀焊管两磅	轻工、医药产品	工艺美术品	雕塑、刻、漆工艺品
新乡市通宝一车焊管16T发新乡	钢铁	钢 材、合金钢材	管材及附件
14和16钢板	钢铁	钢 材、合金钢材	板材
58克高白胶版印刷纸787x1092	轻工、医药产品	纸及制品(十类)	机制纸（新闻纸）
新乡通宝焊管42吨发辉县	钢铁	钢 材、合金钢材	管材及附件
新乡市通宝一车焊管发新乡	钢铁	钢 材、合金钢材	管材及附件
聊城鑫辰发聊城一车焊管	钢铁	铁矿石	管材及附件
江苏大鼎发南通1车热方加焊管	钢铁	钢 材、合金钢材	管材及附件
焊管两票制发郑州	钢铁	钢 材、合金钢材	管材及附件
焊管6寸19件30吨发长治屯留矿	钢铁	钢 材、合金钢材	管材及附件
白方加焊管24T发长治	钢铁	钢 材、合金钢材	管材及附件
68克高白胶版印刷纸880X1230	轻工、医药产品	纸及制品(十类)	机制纸（新闻纸）
热镀加焊管31吨	钢铁	钢 材、合金钢材	管材及附件
55克高白胶版印刷纸1194	轻工、医药产品	纸及制品(十类)	机制纸（新闻纸）
68克克高白胶版印刷纸880X1230	轻工、医药产品	纸及制品(十类)	机制纸（新闻纸）
天柏枫树80	农、林、牧、渔业产品	杂粮	重工业机械、工程机械及零件
1.8米宽8米长的开平板	钢铁	钢 材、合金钢材	板材
新乡市汇通一车焊管加黑方16T运费90一票制发新乡	钢铁	钢 材、合金钢材	管材及附件
亳州宏泽一车热镀加焊管	钢铁	钢 材、合金钢材	管材及附件
80克高白胶版印刷纸710X980	轻工、医药产品	纸及制品(十类)	机制纸（新闻纸）
塑料栈板	钢铁	钢 材、合金钢材	板材
60克高白胶版印刷纸1928	轻工、医药产品	纸及制品(十类)	机制纸（新闻纸）
60克高白胶版印刷纸1905	轻工、医药产品	纸及制品(十类)	机制纸（新闻纸）
热水器及配件	机械设备、电器	电力设备、电器机械及器材	家用电器
安阳豪虹信一车焊管12T发安阳客户自提	钢铁	钢 材、合金钢材	管材及附件
新乡市汇通一车黑方加焊管35T发新乡	钢铁	钢 材、合金钢材	管材及附件
新乡市翔龙一车焊管14T发小店	钢铁	钢 材、合金钢材	管材及附件
新乡市志大一车黑方加焊管15T发新乡	钢铁	钢 材、合金钢材	管材及附件
68克高白胶版印刷纸830X1230	轻工、医药产品	纸及制品(十类)	机制纸（新闻纸）
56克高白胶版印刷纸880X1230	轻工、医药产品	纸及制品(十类)	机制纸（新闻纸）
56克高白胶版印刷纸787X1092	轻工、医药产品	纸及制品(十类)	机制纸（新闻纸）
80克高白胶版印刷纸870	轻工、医药产品	纸及制品(十类)	机制纸（新闻纸）
武汉市鼎源盛发武昌一车黑方加焊管	钢铁	钢 材、合金钢材	管材及附件
制焊管一车31吨发长治襄垣	钢铁	钢 材、合金钢材	管材及附件
度加焊管加白方15T发鹤壁淇县	钢铁	钢 材、合金钢材	管材及附件
78克高白胶版印刷纸984	轻工、医药产品	纸及制品(十类)	机制纸（新闻纸）
95克高白胶版印刷纸1254	轻工、医药产品	纸及制品(十类)	机制纸（新闻纸）
58克高白胶版印刷纸840	轻工、医药产品	纸及制品(十类)	机制纸（新闻纸）
热镀方加焊管	钢铁	钢 材、合金钢材	管材及附件
焊管32T一票制发小店7米管	钢铁	钢 材、合金钢材	管材及附件
75克高白胶版印刷纸838	轻工、医药产品	纸及制品(十类)	机制纸（新闻纸）
115克高白胶版印刷纸940	轻工、医药产品	纸及制品(十类)	机制纸（新闻纸）
床垫	轻工、医药产品	日用工业品	家具、坐具
发小店9米6的车焊管	钢铁	钢 材、合金钢材	管材及附件
55克高白胶版印刷纸925	轻工、医药产品	纸及制品(十类)	机制纸（新闻纸）
白加黑方加焊管过3磅一票制发常州	钢铁	钢 材、合金钢材	管材及附件
焊管家黑方发长垣	钢铁	钢 材、合金钢材	管材及附件
山西世贵物资有限公司焊管一车35吨发太原小店	轻工、医药产品	饮食品	其它未列名饮食及调味食品
汤阴县泰兴一车焊管19T发汤	金属矿石	铁矿石	其它
70克复印纸270X390	轻工、医药产品	纸及制品(十类)	加工纸
木浆GYG	轻工、医药产品	纸及制品(十类)	纸浆
木浆SJ	轻工、医药产品	纸及制品(十类)	纸浆
冰糖	轻工、医药产品	饮食品	糖（固体、浆）
木浆SSH	轻工、医药产品	纸及制品(十类)	纸浆
70克复印纸210	轻工、医药产品	纸及制品(十类)	加工纸
70克复印纸270	轻工、医药产品	纸及制品(十类)	加工纸
80克复印纸	轻工、医药产品	纸及制品(十类)	加工纸
木浆PHJ	轻工、医药产品	纸及制品(十类)	纸浆
箱装烟叶	农、林、牧、渔业产品	经济作物及制品	烟叶、烟草、卷烟、雪茄及代用品
70克胶版印刷纸成品卷筒	轻工、医药产品	纸及制品(十类)	机制纸（新闻纸）
钢板汽运请看清楚要求	钢铁	钢 材、合金钢材	板材
7到10吨耐磨钢板及加工件	钢铁	钢 材、合金钢材	板材
开平板2.75mm	钢铁	钢 材、合金钢材	板材
小钢板	钢铁	钢 材、合金钢材	板材
70复印纸210297	轻工、医药产品	纸及制品(十类)	加工纸
铁链	钢铁	生铁、铁合金、非合金钢	铁合金
薄板	机械设备、电器	电力设备、电器机械及器材	制冷、加热、燃烧设备
钢材方	钢铁	钢 材、合金钢材	管材及附件
饮料LMN	轻工、医药产品	饮食品	饮料、果菜汁
迁安热方钢管	钢铁	钢 材、合金钢材	管材及附件
草块	农、林、牧、渔业产品	竹、木、藤、花、草	花草
广告牌	钢铁	钢铁制品	钢铁件及其它五金制品
热轧圆钢汽运包车	钢铁	钢 材、合金钢材	线材
正大焊管	钢铁	钢 材、合金钢材	管材及附件
津巴粉46.94	金属矿石	铁矿石	其它
津巴粉46.84	金属矿石	铁矿石	其它
建筑手脚架	轻工、医药产品	针织、纺织、皮毛及制品	鞋帽
饮料2008783571	轻工、医药产品	饮食品	饮料、果菜汁
饮料20087800952008772708	轻工、医药产品	饮食品	饮料、果菜汁
饮料2008784804	轻工、医药产品	饮食品	饮料、果菜汁
U型钢	钢铁	钢 材、合金钢材	型材
巴粉47.23	金属矿石	铁矿石	其它
饮料20088087412008813314	轻工、医药产品	饮食品	饮料、果菜汁
厨具	轻工、医药产品	日用工业品	其它日用品
迁安方矩管	钢铁	钢 材、合金钢材	管材及附件
迁安焊钢管	钢铁	钢 材、合金钢材	管材及附件
化工玻璃器皿	轻工、医药产品	日用工业品	玻璃制品
道岔	农、林、牧、渔业产品	经济作物及制品	其它
津粉46.84	金属矿石	铁矿石	其它
饮料200883031020088414162008830311	轻工、医药产品	饮食品	饮料、果菜汁
保温板	钢铁	钢 材、合金钢材	板材
克洛斯5/澳块	金属矿石	铁矿石	其它
t饮料	轻工、医药产品	饮食品	饮料、果菜汁
t矿38.43	金属矿石	铬矿石	其它
面粉（5KG特精粉）	轻工、医药产品	饮食品	糕点、面食、谷物食品
硌矿	金属矿石	铬矿石	其它
巴粉46.94	金属矿石	铁矿石	其它
津粉46.8	金属矿石	铁矿石	其它
铝合金锭	有色金属	铝	铝 锭
焊管38吨	钢铁	钢 材、合金钢材	管材及附件
格兰仕电器	机械设备、电器	专用机械、设备及制品	家用电器
津巴粉49.67％	金属矿石	铁矿石	其它
宜家落地配家具配件	轻工、医药产品	日用工业品	家具、坐具
德旺门锰矿	金属矿石	锰矿石	其它
天津港德龙锰矿	金属矿石	锰矿石	其它
铁粉矿	金属矿石	铁矿石	其它
迁安焊钢钢管	钢铁	钢 材、合金钢材	管材及附件
津巴粉48.4	金属矿石	铁矿石	其它
乙丙橡胶	化工原料及制品	橡胶	合成橡胶
圆棒汽运	钢铁	钢 材、合金钢材	型材
津粉46.86	金属矿石	铁矿石	其它
办公家具	轻工、医药产品	日用工业品	家具、坐具
铝母线	有色金属	铝	铝制品
津粉46.92	金属矿石	铁矿石	其它
宜家家居配件	轻工、医药产品	电力设备、电器机械及器材	家具、坐具
饮料2008903986	轻工、医药产品	饮食品	饮料、果菜汁
海洋2 马来矿	金属矿石	铁矿石	其它
宜家家具配件	轻工、医药产品	日用工业品	家具、坐具
津粉49.2	金属矿石	铁矿石	其它
500g淮盐牌精制食用盐	盐	加工盐	其它
天津锦亿铁矿块050802	其它货类	工艺美术品	其它
玻璃空瓶	轻工、医药产品	日用工业品	玻璃制品
玻璃空瓶滨海	轻工、医药产品	日用工业品	玻璃制品
苜草	农、林、牧、渔业产品	竹、木、藤、花、草	花草
返货醋	轻工、医药产品	饮食品	其它未列名饮食及调味食品
正大方管	钢铁	钢 材、合金钢材	管材及附件
津粉48.4	金属矿石	铁矿石	其它
烟煤0512	煤炭及制品	原煤	烟煤
硅铁一	钢铁	生铁、铁合金、非合金钢	铁合金
海洋2    马来矿	金属矿石	铁矿石	其它
天津锦亿铁矿块0508	其它货类	工艺美术品	其它
饮料2008951810	轻工、医药产品	饮食品	饮料、果菜汁
摩托车配件	机械设备、电器	交通运输设备	道路机动车辆
醋返货	钢铁	钢 材、合金钢材	线材
正大焊加方	钢铁	钢 材、合金钢材	管材及附件
嘉能可铁矿块3596	金属矿石	铁矿石	其它
热轧开平板	钢铁	钢 材、合金钢材	板材
热处理钢板汽车	钢铁	钢 材、合金钢材	板材
方裕方管	钢铁	钢 材、合金钢材	管材及附件
方裕钢材	钢铁	钢 材、合金钢材	管材及附件
配电柜	机械设备、电器	电力设备、电器机械及器材	输变电设备
OKI相思浆	轻工、医药产品	纸及制品(十类)	纸浆
方裕圆管	钢铁	钢 材、合金钢材	管材及附件
饮料2008973500	轻工、医药产品	饮食品	饮料、果菜汁
津巴粉49.67	金属矿石	铁矿石	其它
天虹燃气管	钢铁	钢 材、合金钢材	其它
天虹焊管	钢铁	钢 材、合金钢材	管材及附件
天虹镀锌方管	钢铁	钢 材、合金钢材	管材及附件
天虹方矩管	钢铁	钢 材、合金钢材	管材及附件
天虹热镀管	钢铁	钢 材、合金钢材	管材及附件
辣椒酱	农、林、牧、渔业产品	蔬菜、瓜果及籽实籽仁	蔬菜
矿物水	轻工、医药产品	饮食品	饮料、果菜汁
烟煤0521	煤炭及制品	原煤	烟煤
饮料20089723972008984946	轻工、医药产品	饮食品	饮料、果菜汁
l冷卷	钢铁	钢 材、合金钢材	卷材
冷轧卷板	钢铁	钢 材、合金钢材	卷材
三级抗震钢8盘螺	钢铁	钢 材、合金钢材	线材
8个盘螺	钢铁	钢 材、合金钢材	线材
10个盘螺	钢铁	钢 材、合金钢材	线材
抗震盘螺8E	钢铁	钢 材、合金钢材	线材
5根焊管40B	钢铁	钢 材、合金钢材	管材及附件
20中板11米长	钢铁	钢 材、合金钢材	板材
纸浆板	轻工、医药产品	纸及制品(十类)	纸浆
无缝管32	钢铁	钢 材、合金钢材	管材及附件
无缝管273	钢铁	钢 材、合金钢材	管材及附件
围裙	轻工、医药产品	针织、纺织、皮毛及制品	服装
浆板纸	轻工、医药产品	纸及制品(十类)	纸板（原纸）
抗震8盘螺	钢铁	钢 材、合金钢材	线材
抗震10盘螺	钢铁	钢 材、合金钢材	线材
金鼎浓香菜籽油	农、林、牧、渔业产品	经济作物及制品	动植物食用油料、脂肪及制品
惠美家味精2500g	轻工、医药产品	饮食品	其它未列名饮食及调味食品
惠美家味精1000g	轻工、医药产品	饮食品	其它未列名饮食及调味食品
惠美家味精400g	轻工、医药产品	饮食品	其它未列名饮食及调味食品
无缝管60	钢铁	钢 材、合金钢材	管材及附件
线材65	钢铁	钢 材、合金钢材	线材
惠美家250G味精	轻工、医药产品	饮食品	其它未列名饮食及调味食品
惠美家100G味精	轻工、医药产品	饮食品	其它未列名饮食及调味食品
钢板2米5宽	钢铁	钢 材、合金钢材	板材
钢板2米宽	钢铁	钢 材、合金钢材	板材
钢板14	钢铁	钢 材、合金钢材	板材
钢板30	钢铁	钢 材、合金钢材	板材
钢板16	钢铁	钢 材、合金钢材	板材
钢板20	钢铁	钢 材、合金钢材	板材
低合金18	钢铁	生铁、铁合金、非合金钢	铁合金
金鼎小榨浓香菜籽油5L	农、林、牧、渔业产品	经济作物及制品	动植物食用油料、脂肪及制品
惠美佳100g味精	轻工、医药产品	饮食品	其它未列名饮食及调味食品
惠美佳250g味精	轻工、医药产品	饮食品	其它未列名饮食及调味食品
钢板12	钢铁	钢 材、合金钢材	板材
钢板2米	钢铁	钢 材、合金钢材	板材
钢板2米2宽	钢铁	钢 材、合金钢材	板材
平板纸	轻工、医药产品	纸及制品(十类)	纸制品
钢板40	钢铁	钢 材、合金钢材	板材
管子	钢铁	钢 材、合金钢材	管材及附件
盘螺10线材65	钢铁	钢 材、合金钢材	线材
钢管立柱	钢铁	钢铁制品	钢铁材料、结构体
护栏板	钢铁	钢铁制品	钢铁材料、结构体
钢板2	钢铁	钢 材、合金钢材	板材
钢板3	钢铁	钢 材、合金钢材	板材
钢板8	钢铁	钢 材、合金钢材	板材
钢板10	钢铁	钢 材、合金钢材	板材
小件	钢铁	钢铁制品	钢铁材料、结构体
惠美佳1KG味精	轻工、医药产品	饮食品	其它未列名饮食及调味食品
恒大冰泉	轻工、医药产品	饮食品	饮料、果菜汁
70克精制轻量涂布纸	轻工、医药产品	纸及制品(十类)	机制纸（新闻纸）
52克铜版原纸	轻工、医药产品	纸及制品(十类)	纸板（原纸）
立柱小件	钢铁	钢铁制品	钢铁材料、结构体
中板16	钢铁	钢 材、合金钢材	板材
中板18	钢铁	钢 材、合金钢材	板材
中板20	钢铁	钢 材、合金钢材	板材
福缘酒	轻工、医药产品	饮食品	酒（白酒、啤酒、果酒类）
恒大水	轻工、医药产品	经济作物及制品	经济作物原料、残渣及副产品
焊接立柱	钢铁	钢铁制品	钢铁材料、结构体
钢板10毫米*1.5米*6米	钢铁	钢 材、合金钢材	板材
金鼎一级大豆油	农、林、牧、渔业产品	经济作物及制品	动植物食用油料、脂肪及制品
金鼎一级大豆油5L	农、林、牧、渔业产品	经济作物及制品	动植物食用油料、脂肪及制品
锰卷	钢铁	钢 材、合金钢材	卷材
水	轻工、医药产品	饮食品	饮料、果菜汁
仪器设备	机械设备、电器	仪器仪表、计量器具、工具	仪器仪表
金鼎葵花籽油	农、林、牧、渔业产品	经济作物及制品	动植物食用油料、脂肪及制品
金鼎大豆油	农、林、牧、渔业产品	经济作物及制品	动植物食用油料、脂肪及制品
钢立柱钢支架及小件	钢铁	钢铁制品	钢铁件及其它五金制品
太阳能板	机械设备、电器	电子、电讯设备及器材	电池、蓄电池
金鼎调和油5L	农、林、牧、渔业产品	经济作物及制品	动植物食用油料、脂肪及制品
立柱护栏板小件	钢铁	钢铁制品	钢铁材料、结构体
6抗震盘螺	钢铁	钢 材、合金钢材	线材
热镀锌管	钢铁	钢 材、合金钢材	管材及附件
黑方管	钢铁	钢 材、合金钢材	管材及附件
线材、盘螺	钢铁	钢 材、合金钢材	线材
70克全木浆复印纸	轻工、医药产品	纸及制品(十类)	机制纸（新闻纸）
70克全木浆复印纸846	轻工、医药产品	纸及制品(十类)	机制纸（新闻纸）
声屏障钢柱	钢铁	钢铁制品	钢铁材料、结构体
声屏障钢立柱	钢铁	钢铁制品	钢铁材料、结构体
焊柱	钢铁	钢铁制品	钢铁材料、结构体
58克全木浆胶版纸	轻工、医药产品	纸及制品(十类)	纸板（原纸）
球扁钢	钢铁	钢 材、合金钢材	型材
钢坯	钢铁	钢锭、坯	铸、锻钢材
64克精制轻量涂布纸	轻工、医药产品	纸及制品(十类)	机制纸（新闻纸）
小树苗广玉兰	农、林、牧、渔业产品	竹、木、藤、花、草	树木
螺纹、线材	钢铁	钢 材、合金钢材	线材
焊柱立柱	钢铁	钢铁制品	钢铁材料、结构体
70克胶板印刷纸	轻工、医药产品	纸及制品(十类)	机制纸（新闻纸）
118克全木浆胶版纸	轻工、医药产品	纸及制品(十类)	纸板（原纸）
98克全木浆胶版纸	轻工、医药产品	纸及制品(十类)	纸板（原纸）
法兰立柱小件方管	钢铁	钢铁制品	钢铁材料、结构体
三级抗震8盘	钢铁	钢 材、合金钢材	线材
钢柱	钢铁	钢铁制品	钢铁材料、结构体
热轧钢	钢铁	钢 材、合金钢材	带材
拖泵	农、林、牧、渔业产品	蔬菜、瓜果及籽实籽仁	动植物食用油料、脂肪及制品
钢架子	钢铁	钢铁制品	钢铁材料、结构体
h型钢	钢铁	钢 材、合金钢材	型材
80克胶板印刷纸	轻工、医药产品	纸及制品(十类)	机制纸（新闻纸）
方便面	轻工、医药产品	饮食品	糕点、面食、谷物食品
纸	轻工、医药产品	纸及制品(十类)	其它纸及制品
标志杆小件	钢铁	钢铁制品	钢铁材料、结构体
镀锌开平板	钢铁	钢 材、合金钢材	板材
立柱焊柱	钢铁	钢铁制品	钢铁材料、结构体
标志杆	钢铁	钢铁制品	钢铁材料、结构体
护栏立柱小件	钢铁	钢铁制品	钢铁材料、结构体
立柱槽钢	钢铁	钢 材、合金钢材	型材
浆纸	其它货类	纸及制品(十类)	其它
精铝	有色金属	铝	精铝及铝材
汽车轮毂	机械设备、电器	交通运输设备	道路机动车辆
饮品	轻工、医药产品	饮食品	饮料、果菜汁
化纤	轻工、医药产品	针织、纺织、皮毛及制品	纱、线、丝、纤维（非复合材料）
镀锌钢管	钢铁	钢 材、合金钢材	管材及附件
树脂粉	金属矿石	铁矿石	其它
船运角钢	钢铁	钢 材、合金钢材	型材
浆板	轻工、医药产品	纸及制品(十类)	纸浆
成品电线电缆	机械设备、电器	电力设备、电器机械及器材	电工器材
方管镀锌产品	钢铁	钢 材、合金钢材	管材及附件
水陆联运角钢	钢铁	钢 材、合金钢材	型材
70克全木浆胶版纸	轻工、医药产品	纸及制品(十类)	纸板（原纸）
80克全木浆胶版纸	轻工、医药产品	纸及制品(十类)	纸板（原纸）
100克全木浆胶版纸	轻工、医药产品	纸及制品(十类)	纸板（原纸）
80克精制轻量涂布纸	轻工、医药产品	纸及制品(十类)	机制纸（新闻纸）
60克全木浆胶版纸	轻工、医药产品	纸及制品(十类)	纸板（原纸）
68克全木浆胶版纸	轻工、医药产品	纸及制品(十类)	纸板（原纸）
标志杆双柱	钢铁	钢铁制品	钢铁材料、结构体
H型钢立柱	钢铁	钢 材、合金钢材	线材
乌针浆	轻工、医药产品	纸及制品(十类)	纸浆
护栏板立柱焊柱	钢铁	钢铁制品	钢铁材料、结构体
镀锌产品方管	钢铁	钢 材、合金钢材	管材及附件
热方管黑方管	钢铁	钢 材、合金钢材	管材及附件
护栏板焊柱小件	钢铁	钢铁制品	钢铁材料、结构体
冷轧钢卷	钢铁	钢 材、合金钢材	卷材
铜板	钢铁	钢 材、合金钢材	板材
65克全木浆胶版纸	轻工、医药产品	纸及制品(十类)	纸板（原纸）
80克象牙白道林纸	轻工、医药产品	纸及制品(十类)	机制纸（新闻纸）
100克象牙白道林纸	轻工、医药产品	纸及制品(十类)	机制纸（新闻纸）
喷塑声屏障钢柱	钢铁	钢铁制品	钢铁材料、结构体
70克胶版印刷纸	轻工、医药产品	纸及制品(十类)	机制纸（新闻纸）
80克胶版印刷纸	轻工、医药产品	纸及制品(十类)	机制纸（新闻纸）
热轧钢板水陆联运详细见备注	钢铁	钢 材、合金钢材	板材
钢立柱盖板钢支架	钢铁	钢铁制品	钢铁材料、结构体
热轧钢板水运详细在备注	钢铁	钢 材、合金钢材	板材
80克薄本纸	轻工、医药产品	纸及制品(十类)	其它纸及制品
卡槽	钢铁	钢 材、合金钢材	型材
声屏障H型钢立柱	钢铁	钢铁制品	钢铁材料、结构体
护栏板标志杆	钢铁	钢铁制品	钢铁材料、结构体
羊皮	轻工、医药产品	针织、纺织、皮毛及制品	皮毛制品
热轧钢板船运	钢铁	钢 材、合金钢材	板材
热轧钢板船运重招	钢铁	钢 材、合金钢材	板材
68克胶版印刷纸	轻工、医药产品	纸及制品(十类)	机制纸（新闻纸）
70克精制轻量涂布纸象牙白道林纸	轻工、医药产品	纸及制品(十类)	机制纸（新闻纸）
70克象牙白道林纸	轻工、医药产品	纸及制品(十类)	机制纸（新闻纸）
58克精制轻量涂布纸	轻工、医药产品	纸及制品(十类)	机制纸（新闻纸）
120克象牙白道林纸	轻工、医药产品	纸及制品(十类)	机制纸（新闻纸）
62克精制轻量涂布纸	轻工、医药产品	纸及制品(十类)	机制纸（新闻纸）
热镀锌钢立柱钢支架扁钢	钢铁	钢 材、合金钢材	管材及附件
奶油	轻工、医药产品	饮食品	乳制品，蜂蜜、王浆、粉
五金	钢铁	钢铁制品	铸、锻钢材
胶片	轻工、医药产品	饮食品	纸制品
天然橡胶	化工原料及制品	橡胶	天然橡胶
开平板工字钢方管	钢铁	钢 材、合金钢材	管材及附件
方矩管苏AM2499	钢铁	钢 材、合金钢材	管材及附件
方矩管苏AL4508	钢铁	钢 材、合金钢材	管材及附件
缸体	机械设备、电器	普通工业机械及设备	通用零部件
纺织品	轻工、医药产品	针织、纺织、皮毛及制品	针织、纺织制品
铁粉	金属矿石	生铁、铁合金、非合金钢	其它
电机	机械设备、电器	普通工业机械及设备	锅炉、发动机 动力装置及辅助设备
热方管	钢铁	钢 材、合金钢材	管材及附件
方矩管胜宝冀JE3917	钢铁	钢 材、合金钢材	管材及附件
方矩管苏HW3292	钢铁	钢 材、合金钢材	管材及附件
方矩管苏HW2265	钢铁	钢 材、合金钢材	管材及附件
供电设备	机械设备、电器	普通工业机械及设备	其它电器设备
无水葡萄糖	轻工、医药产品	饮食品	糖（固体、浆）
热镀锌板	钢铁	钢 材、合金钢材	板材
白板纸	轻工、医药产品	纸及制品(十类)	纸板（原纸）
卷布	轻工、医药产品	针织、纺织、皮毛及制品	布匹（机织、绒织、网织物、纱罗）
热镀锌卷	钢铁	钢 材、合金钢材	管材及附件
玻璃纤维布	轻工、医药产品	针织、纺织、皮毛及制品	纱、线、丝、纤维（非复合材料）
方矩管苏AC5857	钢铁	钢 材、合金钢材	管材及附件
方矩管苏AJ3680	钢铁	钢 材、合金钢材	管材及附件
酱油	轻工、医药产品	饮食品	其它未列名饮食及调味食品
方矩管苏CW8739	钢铁	钢 材、合金钢材	管材及附件
方矩管苏HW8358	钢铁	钢 材、合金钢材	管材及附件
方矩管苏AJ8392	钢铁	钢 材、合金钢材	管材及附件
镀锌方矩管	钢铁	钢 材、合金钢材	管材及附件
手机展柜	钢铁	钢铁制品	钢铁容器
热镀锌焊管	钢铁	钢 材、合金钢材	管材及附件
热镀锌方距管	钢铁	钢 材、合金钢材	管材及附件
黑方距管	钢铁	钢 材、合金钢材	管材及附件
太平洋浆	轻工、医药产品	纸及制品(十类)	纸浆
风机配件	机械设备、电器	普通工业机械及设备	通用设备
全自动裁布机	机械设备、电器	专用机械、设备及制品	轻工业机械及零件
变压器	机械设备、电器	电力设备、电器机械及器材	输变电设备
重型锻压机	机械设备、电器	普通工业机械及设备	金属加工机械及设备
方距管镀锌管	钢铁	钢 材、合金钢材	管材及附件
镀带方镀带圆	钢铁	钢铁制品	钢铁件及其它五金制品
袋装麦精	轻工、医药产品	饮食品	其它未列名饮食及调味食品
化妆品	轻工、医药产品	工艺美术品	雕塑、刻、漆工艺品
家电	机械设备、电器	电力设备、电器机械及器材	家用电器
集箱新货场六条到八士	机械设备、电器	普通工业机械及设备	锅炉、发动机 动力装置及辅助设备
方矩管苏HW8292	钢铁	钢 材、合金钢材	管材及附件
镀锌板和镀锌卷	钢铁	钢 材、合金钢材	管材及附件
镀锌带方矩	钢铁	钢 材、合金钢材	管材及附件
冰箱洗衣机	机械设备、电器	电力设备、电器机械及器材	家用电器
方矩管苏CCL819	钢铁	钢 材、合金钢材	管材及附件
方矩管苏HW4553	钢铁	钢 材、合金钢材	管材及附件
方矩管苏AM2255	钢铁	钢 材、合金钢材	管材及附件
蓝标胶版印刷	轻工、医药产品	纸及制品(十类)	机制纸（新闻纸）
福瑞味精	轻工、医药产品	饮食品	其它未列名饮食及调味食品
东北福瑞味精	轻工、医药产品	饮食品	其它未列名饮食及调味食品
黑方矩管	钢铁	钢 材、合金钢材	管材及附件
电焊设备	机械设备、电器	普通工业机械及设备	金属加工机械及设备
冰箱	机械设备、电器	电力设备、电器机械及器材	家用电器
汽化器	机械设备、电器	专用机械、设备及制品	制冷、加热、燃烧设备
热卷	钢铁	钢 材、合金钢材	卷材
西部粉铁矿	金属矿石	铁矿石	其它
方矩管苏AM2652	钢铁	钢 材、合金钢材	管材及附件
复印机	机械设备、电器	专用机械、设备及制品	文化办公机械、设备
玻璃瓶	轻工、医药产品	日用工业品	玻璃制品
谷子	轻工、医药产品	蔬菜、瓜果及籽实籽仁	金属制品
方矩管苏L21322	钢铁	钢 材、合金钢材	管材及附件
方矩管苏J15953	钢铁	钢 材、合金钢材	管材及附件
阜丰味精	轻工、医药产品	饮食品	其它未列名饮食及调味食品
方矩管苏HW8280	钢铁	钢 材、合金钢材	管材及附件
胚芽粕	农、林、牧、渔业产品	经济作物及制品	经济作物原料、残渣及副产品
热镀管焊管螺旋管	钢铁	钢 材、合金钢材	管材及附件
焊管方矩管	钢铁	钢 材、合金钢材	管材及附件
焊管热镀螺旋	钢铁	钢 材、合金钢材	管材及附件
方矩管苏AM7366	钢铁	钢 材、合金钢材	管材及附件
王子本色浆	轻工、医药产品	日用工业品	家具、坐具
家纺	轻工、医药产品	针织、纺织、皮毛及制品	针织、纺织制品
方矩管热方	钢铁	钢 材、合金钢材	管材及附件
成品纸	轻工、医药产品	纸及制品(十类)	其它
布料	轻工、医药产品	针织、纺织、皮毛及制品	其它
热度管钢塑管	钢铁	钢 材、合金钢材	管材及附件
C型钢	钢铁	钢 材、合金钢材	型材
热镀管钢塑	钢铁	钢 材、合金钢材	管材及附件
电视	机械设备、电器	电力设备、电器机械及器材	家用电器
金星浆	轻工、医药产品	纸及制品(十类)	纸浆
方矩管苏AM7021	钢铁	钢 材、合金钢材	管材及附件
PC160824000013空调箔	机械设备、电器	电力设备、电器机械及器材	家用电器
镀角钢	钢铁	钢 材、合金钢材	型材
方矩管苏HW3482	钢铁	钢 材、合金钢材	管材及附件
健身器材	轻工、医药产品	文化体育用品	体育运动用品及零件、附件
热镀钢塑管	钢铁	钢 材、合金钢材	管材及附件
瓦楞纸	轻工、医药产品	纸及制品(十类)	其它纸及制品
互感器	机械设备、电器	电子、电讯设备及器材	电子、光、磁、超声波装置的元器件、零件、附件
电容器	机械设备、电器	电子、电讯设备及器材	电子、光、磁、超声波装置的元器件、零件、附件
风机	机械设备、电器	普通工业机械及设备	通用设备
热镀圆管	钢铁	钢 材、合金钢材	管材及附件
热方矩管	钢铁	钢 材、合金钢材	管材及附件
立柱、小件	钢铁	钢铁制品	钢铁材料、结构体
2.15米焊接立柱	钢铁	钢铁制品	钢铁材料、结构体
绿豆	粮食	杂粮	杂豆
冷卷	钢铁	钢 材、合金钢材	卷材
电流互感器	机械设备、电器	电子、电讯设备及器材	电子、光、磁、超声波装置的元器件、零件、附件
红土镍矿	农、林、牧、渔业产品	饮食品	其它未列名饮食及调味食品
加蓬矿	金属矿石	铁矿石	其它
